Race Drivin'	R/Race Drivin	A-Games:R/RaceDrivin/RaceDrivin.slave
Race Drivin' NoIntro	R/Race Drivin NoIntro	A-Games:R/RaceDrivinNoIntro/RaceDrivinNoIntro.slave
Rackney's Island	R/Rackneys Island	A-Games:R/RackneysIsland/RackneysIsland.Slave
Racter	R/Racter	A-Games:R/Racter/Racter.Slave
Raffles	R/Raffles	A-Games:R/Raffles/Raffles.slave
Raffles CDTV	R/Raffles CDTV	A-Games:R/RafflesCDTV/RafflesCDTV.slave
Rage (CAD Software)	R/Rage CAD Software	A-Games:R/RageV1/RageV1.Slave
Rage (CAD Software)	R/Rage CAD Software 	A-Games:R/RageV2/RageV2.Slave
Raider	R/Raider	A-Games:R/Raider/Raider.Slave
Raiders, The FR	R/Raiders. The FR	A-Games:R/RaidersFr/RaidersFr.Slave
Railroad Tycoon	R/Railroad Tycoon	A-Games:R/RailroadTycoon/RailroadTycoon.slave
Railroad Tycoon DE	R/Railroad Tycoon DE	A-Games:R/RailroadTycoonDe/RailroadTycoonDe.slave
Railroad Tycoon FR	R/Railroad Tycoon FR	A-Games:R/RailroadTycoonFr/RailroadTycoonFr.slave
Rainbow Islands	R/Rainbow Islands	A-Games:R/RainbowIslands/RainbowIslands.slave
Rainbow Warrior	R/Rainbow Warrior	A-Games:R/RainbowWarrior/RainbowWarrior.Slave
Rally Championships	R/Rally Championships	A-Games:R/RallyChampionships/RallyChampionships.Slave
Rally Championships AGA	R/Rally Championships AGA	A-Games:R/RallyChampionshipsAGA/RallyChampionshipsAGA.Slave
Rally Cross Challenge	R/Rally Cross Challenge	A-Games:R/RallyCrossChallenge/RallyCrossChallenge.Slave
Rambo III	R/Rambo III	A-Games:R/Rambo3/Rambo3.slave
Rambo III NTSC	R/Rambo III NTSC	A-Games:R/Rambo3NTSC/Rambo3NTSC.slave
Rampage	R/Rampage	A-Games:R/Rampage/Rampage.slave
Rampart	R/Rampart	A-Games:R/Rampart/Rampart.Slave
Ranx	R/Ranx	A-Games:R/RanX/RanX.Slave
Ranx DE	R/Ranx DE	A-Games:R/RanXDe/RanXDe.Slave
Ranx FR	R/Ranx FR	A-Games:R/RanXFr/RanXFr.Slave
Rat Trap	R/Rat Trap	A-Games:R/RatTrap/RatTrap.Slave
R.B.I. 2 Baseball	R/R.B.I. 2 Baseball	A-Games:R/RBI2Baseball/RBI2Baseball.Slave
Read & Rhyme	R/Read Rhyme	A-Games:R/Read&Rhyme/Read&Rhyme.Slave
Real Ghostbusters, The	R/Real Ghostbusters. The	A-Games:R/RealGhostbusters/RealGhostbusters.Slave
Realms	R/Realms	A-Games:R/Realms/Realms.Slave
Realms of Arkania: Blade of Destiny	R/Realms of Arkania Blade of	A-Games:R/RealmsOfArkania/RealmsOfArkania.Slave
Real Popeye, The	R/Real Popeye. The	A-Games:R/RealPopeye/RealPopeye.Slave
Rebellion	R/Rebellion	A-Games:R/Rebellion/Rebellion.slave
Red Baron	R/Red Baron	A-Games:R/RedBaron/RedBaron.slave
Red Baron DE	R/Red Baron DE	A-Games:R/RedBaronDe/RedBaronDe.slave
Red Heat	R/Red Heat	A-Games:R/RedHeat/RedHeat.slave
Red Lightning NTSC	R/Red Lightning NTSC	A-Games:R/RedLightningNTSC/RedLightningNTSC.slave
Red Storm Rising	R/Red Storm Rising	A-Games:R/RedStormRising/RedStormRising.Slave
Red Zone	R/Red Zone	A-Games:R/RedZone/RedZone.Slave
Reflexity: Pinball Challenge	R/Reflexity Pinball Challeng	A-Games:R/Reflexity/Reflexity.Slave
Renaissance	R/Renaissance	A-Games:R/Renaissance/Renaissance.Slave
Renegade	R/Renegade	A-Games:R/Renegade/Renegade.slave
Renegade III: The Final Chapter	R/Renegade III The Final Cha	A-Games:R/Renegade3/Renegade3.Slave
Renegades Deluxe	R/Renegades Deluxe	A-Games:R/Renegades/Renegades.Slave
Renegades Deluxe Editor	R/Renegades Deluxe Editor	A-Games:R/Renegades/RenegadesEditor.Slave
Resolution 101	R/Resolution 101	A-Games:R/Resolution101/Resolution101.Slave
Return to Atlantis	R/Return to Atlantis	A-Games:R/ReturnToAtlantis/ReturnToAtlantis.Slave
Return to Genesis	R/Return to Genesis	A-Games:R/ReturnToGenesis/ReturnToGenesis.Slave
Reunion	R/Reunion	A-Games:R/Reunion/Reunion.slave
Reunion AGA	R/Reunion AGA	A-Games:R/ReunionAGA/ReunionAGA.slave
Reunion DE AGA	R/Reunion DE AGA	A-Games:R/ReunionAGADe/ReunionAGADe.slave
Reunion DE	R/Reunion DE	A-Games:R/ReunionDe/ReunionDe.slave
Revelation!	R/Revelation	A-Games:R/Revelation/Revelation.Slave
Revenge of Defender	R/Revenge of Defender	A-Games:R/RevengeOfDefender/RevengeOfDefender.slave
Revenge of the Mutant Camels	R/Revenge of the Mutant Came	A-Games:R/RevengeOfMutantCamels/RevengeOfMutantCamels.Slave
Revenge of the Mutant Camels II	R/Revenge of the Mutant C V2	A-Games:R/RevengeOfMutantCamels2/RevengeOfMutantCamels2.slave
Revenge of the Mutant Camels NTSC	R/Revenge of the Mutant C V3	A-Games:R/RevengeOfMutantCamelsNTSC/RevengeOfMutantCamelsNTSC.Slave
Rick Dangerous	R/Rick Dangerous	A-Games:R/RickDangerous/RickDangerous.Slave
Rick Dangerous II	R/Rick Dangerous II	A-Games:R/RickDangerous2/RickDangerous2.slave
Rick Dangerous II	R/Rick Dangerous II 	A-Games:R/RickDangerous25/RickDangerous25.Slave
Ringside	R/Ringside	A-Games:R/Ringside/Ringside.Slave
Rings of Medusa	R/Rings of Medusa	A-Games:R/RingsOfMedusa/RingsOfMedusa.Slave
Rings of Medusa DE	R/Rings of Medusa DE	A-Games:R/RingsOfMedusaDe/RingsOfMedusaDe.Slave
Rings of Medusa FR	R/Rings of Medusa FR	A-Games:R/RingsOfMedusaFr/RingsOfMedusaFr.Slave
Rings of Medusa Gold DE	R/Rings of Medusa Gold DE	A-Games:R/RingsOfMedusaGoldDe/RingsOfMedusaGoldDe.Slave
Rise of the Dragon	R/Rise of the Dragon	A-Games:R/RiseOfTheDragon/RiseOfTheDragon.Slave
Rise of the Dragon DE	R/Rise of the Dragon DE	A-Games:R/RiseOfTheDragonDe/RiseOfTheDragonDe.Slave
Rise of the Robots	R/Rise of the Robots	A-Games:R/RiseOftheRobots/RiseOfTheRobots.slave
Rise of the Robots AGA	R/Rise of the Robots AGA	A-Games:R/RiseOfTheRobotsAGA/RiseOfTheRobotsAGA.slave
Rise of the Robots CD32	R/Rise of the Robots CD32	A-Games:R/RiseOfTheRobotsCD32/RiseOfTheRobotsCD32.slave
RISK	R/RISK	A-Games:R/Risk/Risk.Slave
Risky Woods	R/Risky Woods	A-Games:R/RiskyWoods/RiskyWoods.Slave
RoadBlasters	R/RoadBlasters	A-Games:R/RoadBlasters/RoadBlasters.Slave
Roadkill AGA	R/Roadkill AGA	A-Games:R/RoadkillAGA/RoadkillAGA.Slave
Roadkill CD32	R/Roadkill CD32	A-Games:R/RoadkillCD32/RoadKillCD32.Slave
Roadkill CD32 NoIntro	R/Roadkill CD32 NoIntro	A-Games:R/RoadkillCD32NoIntro/RoadKillCD32NoIntro.Slave
Road Rash	R/Road Rash	A-Games:R/RoadRash/RoadRash.Slave
Roadwar Europa	R/Roadwar Europa	A-Games:R/RoadwarEuropa/RoadwarEuropa.Slave
Roadwars	R/Roadwars	A-Games:R/RoadWars/RoadWars.Slave
Roadwars	R/Roadwars 	A-Games:R/RoadWarsArcadia/RoadWarsArcadia.Slave
Robbeary	R/Robbeary	A-Games:R/Robbeary/Robbeary.Slave
Robin Hood: Legend Quest	R/Robin Hood Legend Quest	A-Games:R/RobinHoodLegendQuest/RobinHoodLegendQuest.slave
Robinson's Requiem	R/Robinsons Requiem	A-Games:R/RobinsonsRequiem/RobinsonsRequiem.Slave
Robinson's Requiem AGA	R/Robinsons Requiem AGA	A-Games:R/RobinsonsRequiemAGA/RobinsonsRequiemAGA.Slave
RoboCop	R/RoboCop	A-Games:R/RoboCop/RoboCop.Slave
RoboCop 2	R/RoboCop 2	A-Games:R/RoboCop2/RoboCop2.Slave
RoboCop 3	R/RoboCop 3	A-Games:R/RoboCop3/RoboCop3.slave
RoboCop 3 NTSC	R/RoboCop 3 NTSC	A-Games:R/RoboCop3NTSC/RoboCop3NTSC.slave
RoboSport	R/RoboSport	A-Games:R/RoboSport/RoboSport.Slave
Roboter DE	R/Roboter DE	A-Games:R/RoboterDe/RoboterDe.Slave
Robotnic	R/Robotnic	A-Games:R/Robotnic/Robotnic.Slave
Robot Readers: Aesop's Fables	R/Robot Readers Aesops Fable	A-Games:R/RobotReaderAesopsFables/RobotReaderAesopsFables.Slave
Robot Readers: Chicken Little	R/Robot Readers Chicken Litt	A-Games:R/RobotReaderChickenLittle/RobotReaderChickenLittle.Slave
Robozone	R/Robozone	A-Games:R/Robozone/Robozone.slave
Rock Challenge	R/Rock Challenge	A-Games:R/RockChallenge/RockChallenge.slave
Rocket Ranger	R/Rocket Ranger	A-Games:R/RocketRanger/RocketRanger.Slave
Rocket Ranger Censored	R/Rocket Ranger Censored	A-Games:R/RocketRangerCensored/RocketRangerCensored.Slave
Rocket Ranger NTSC	R/Rocket Ranger NTSC	A-Games:R/RocketRangerNTSC/RocketRangerNTSC.Slave
Rockford	R/Rockford	A-Games:R/Rockford/Rockford.slave
Rock'n Roll	R/Rockn Roll	A-Games:R/RockNRoll/RockNRoll.Slave
Rock Star Ate My Hamster	R/Rock Star Ate My Hamster	A-Games:R/RockStarAteMyHamster/RockStarAteMyHamster.slave
Rock Star FR	R/Rock Star FR	A-Games:R/RockStarFr/RockStarFr.slave
Rockstar: Never Trust Rotten Tangerines PL	R/Rockstar Never Trust Rotte	A-Games:R/RockstarNTRTPl/RockstarNTRTPl.Slave
Rodland	R/Rodland	A-Games:R/RodLand/RodLand.Slave
Rody & Mastico II FR	R/Rody Mastico II FR	A-Games:R/Rody&Mastico2Fr/Rody&Mastico2Fr.Slave
Rody & Mastico III FR	R/Rody Mastico III FR	A-Games:R/Rody&Mastico3Fr/Rody&Mastico3Fr.Slave
Rody Noël FR	R/Rody Noel FR	A-Games:R/Rody&Mastico4RodyNoelFr/Rody&Mastico4RodyNoelFr.Slave
Rody V FR	R/Rody V FR	A-Games:R/Rody&Mastico5Fr/Rody&Mastico5Fr.Slave
Rody VI FR	R/Rody VI FR	A-Games:R/Rody&Mastico6Fr/Rody&Mastico6Fr.Slave
Rody & Mastico DE	R/Rody Mastico DE	A-Games:R/Rody&MasticoDe/Rody&MasticoDe.Slave
Rody & Mastico FR	R/Rody Mastico FR	A-Games:R/Rody&MasticoFr/Rody&MasticoFr.Slave
Rogue: The Adventure Game	R/Rogue The Adventure Game	A-Games:R/Rogue/Rogue.Slave
Rogue Trooper	R/Rogue Trooper	A-Games:R/RogueTrooper/RogueTrooper.Slave
Roketz AGA	R/Roketz AGA	A-Games:R/RoketzAGA/RoketzAGA.Slave
RollerCoaster Rumbler	R/RollerCoaster Rumbler	A-Games:R/RollerCoasterRumbler/RollerCoasterRumbler.Slave
Rolling Ronny	R/Rolling Ronny	A-Games:R/RollingRonny/RollingRonny.Slave
Roll or Die	R/Roll or Die	A-Games:R/RollOrDie/RollOrDie.slave
Rome AD92: The Pathway To Power	R/Rome AD92 The Pathway To P	A-Games:R/RomeAD92/RomeAD92.Slave
Rotor	R/Rotor	A-Games:R/Rotor/Rotor.slave
Rotox	R/Rotox	A-Games:R/Rotox/Rotox.slave
Round the Bend!	R/Round the Bend	A-Games:R/RoundTheBend/RoundTheBend.Slave
R-Type	R/R-Type	A-Games:R/RType/RType.Slave
R-Type II	R/R-Type II	A-Games:R/RType2/RType2.Slave
Rubicon	R/Rubicon	A-Games:R/Rubicon/Rubicon.slave
Rüsselsheim DE	R/Russelsheim DE	A-Games:R/RuesselsheimDe/RuesselsheimDe.Slave
Ruff and Reddy in the Space Adventure	R/Ruff and Reddy in the Spac	A-Games:R/Ruff&ReddySpaceAdventure/Ruff&ReddySpaceAdventure.slave
Ruffian	R/Ruffian	A-Games:R/Ruffian/Ruffian.Slave
Ruff 'n' Tumble	R/Ruff n Tumble	A-Games:R/RuffNTumble/RuffNTumble.slave
Rugby: The World Cup	R/Rugby The World Cup	A-Games:R/RugbyTheWorldCup/RugbyTheWorldCup.Slave
Rugby: The World Cup RugbyTheWorldCupEarlyBld	R/Rugby The World Cup RugbyT	A-Games:R/RugbyTheWorldCupEarlyBuild/RugbyTheWorldCupEarlyBld.Slave
Running Man, The	R/Running Man. The	A-Games:R/RunningMan/RunningMan.slave
Run the Gauntlet	R/Run the Gauntlet	A-Games:R/RunTheGauntlet/RunTheGauntlet.Slave
Rushhour	R/Rushhour	A-Games:R/Rushhour/Rushhour.Slave
RVF Honda	R/RVF Honda	A-Games:R/RVFHonda/RVFHonda.slave