Misadventures of Flink, The CD32	M/Misadventures of Flink. Th	A-Games:F/FlinkCD32/FlinkCD32.Slave
M1 Tank Platoon	M/M1 Tank Platoon	A-Games:M/M1TankPlatoon/M1TankPlatoon.Slave
Mach 3	M/Mach 3	A-Games:M/Mach3/Mach3.Slave
Mad Professor Mariarti	M/Mad Professor Mariarti	A-Games:M/MadProfessorMariarti/MadProfessorMariarti.slave
Mad Show	M/Mad Show	A-Games:M/MadShow/MadShow.Slave
Mad Show FR	M/Mad Show FR	A-Games:M/MadShowFr/MadShowFr.Slave
Mad TV	M/Mad TV	A-Games:M/MadTV/MadTV.Slave
Mad TV DE	M/Mad TV DE	A-Games:M/MadTVDe/MadTVDe.Slave
Mad TV FR	M/Mad TV FR	A-Games:M/MadTVFr/MadTVFr.Slave
Mafdet and the Book of the Dead	M/Mafdet and the Book of the	A-Games:M/MafdetAndTheBookOfTheDead/MafdetAndTheBookOfTheDead.slave
Magic Boy	M/Magic Boy	A-Games:M/MagicBoy/MagicBoy.slave
Magic Fly 1MB	M/Magic Fly 1MB	A-Games:M/MagicFly1MB/MagicFly1MB.Slave
Magic Fly 512KB	M/Magic Fly 512KB	A-Games:M/MagicFly512KB/MagicFly512KB.Slave
Magician, The	M/Magician. The	A-Games:M/Magician/Magician.Slave
Magic Johnson's Fast Break	M/Magic Johnsons Fast Break	A-Games:M/MagicJohnsonFstBrkArcadia/MagicJohnsonFstBrkArcadia.Slave
Magic Johnson's Basketball	M/Magic Johnsons Basketball	A-Games:M/MagicJohnsonsBasketball/MagicJohnsonsBasketball.Slave
Magicland Dizzy	M/Magicland Dizzy	A-Games:M/MagiclandDizzy/MagiclandDizzy.Slave
Magic Lines	M/Magic Lines	A-Games:M/MagicLines/MagicLines.Slave
Magic Marble	M/Magic Marble	A-Games:M/MagicMarble/MagicMarble.Slave
Magic Pockets	M/Magic Pockets	A-Games:M/MagicPockets/MagicPockets.slave
Magic Pockets Demo	M/Magic Pockets Demo	A-Games:M/MagicPocketsDemo/MagicPocketsDemo.Slave
Magic Pockets NTSC	M/Magic Pockets NTSC	A-Games:M/MagicPocketsNTSC/MagicPocketsNTSC.slave
Magnatron	M/Magnatron	A-Games:M/Magnatron/Magnatron.Slave
Major Motion	M/Major Motion	A-Games:M/MajorMotion/MajorMotion.Slave
Manchester United	M/Manchester United	A-Games:M/ManchesterUnited/ManchesterUnited.Slave
Manchester United Europe	M/Manchester United Europe	A-Games:M/ManchesterUnitedEurope20/ManchesterUnitedEurope20.Slave
Manchester United Europe	M/Manchester United Europe 	A-Games:M/ManchesterUnitedEurope21/ManchesterUnitedEurope21.Slave
Manchester United Europe	M/Manchester United Europe  	A-Games:M/ManchesterUnitedEurope23/ManchesterUnitedEurope23.Slave
Manchester United: Premier League Champions	M/Manchester United Premier	A-Games:M/ManchesterUnitedPLC/ManchesterUnitedPLC.slave
Manchester United: The Double	M/Manchester United The Doub	A-Games:M/ManchesterUnitedTheDouble/ManchesterUnitedTheDouble.slave
Manchester United: Premier League Champions Data	M/Manchester United Premier 	A-Games:M/ManchesterUtdPLC&Data/ManchesterUtdPLC&Data.slave
Man from the Council, The	M/Man from the Council. The	A-Games:M/ManFromTheCouncil/ManFromTheCouncil.Slave
Manhattan Dealers	M/Manhattan Dealers	A-Games:M/ManhattanDealers/ManhattanDealers.Slave
Manhattan Dealers FR	M/Manhattan Dealers FR	A-Games:M/ManhattanDealersFr/ManhattanDealersFr.Slave
Manhunter: New York	M/Manhunter New York	A-Games:M/Manhunter/Manhunter.slave
Manhunter 2: San Francisco NTSC	M/Manhunter 2 San Francisco	A-Games:M/Manhunter2NTSC/Manhunter2NTSC.slave
Maniac Mansion	M/Maniac Mansion	A-Games:M/ManiacMansion/ManiacMansion.slave
Maniac Mansion DE	M/Maniac Mansion DE	A-Games:M/ManiacMansionDe/ManiacMansionDe.slave
Maniac Mansion ES	M/Maniac Mansion ES	A-Games:M/ManiacMansionEs/ManiacMansionEs.slave
Maniac Mansion FR	M/Maniac Mansion FR	A-Games:M/ManiacMansionFr/ManiacMansionFr.slave
Maniac Mansion IT	M/Maniac Mansion IT	A-Games:M/ManiacMansionIt/ManiacMansionIt.slave
Maniax	M/Maniax	A-Games:M/Maniax/maniax.slave
Manic Miner	M/Manic Miner	A-Games:M/ManicMiner/ManicMiner.slave
Manix	M/Manix	A-Games:M/Manix/Manix.Slave
Mortville Manor FR	M/Mortville Manor FR	A-Games:M/ManoirDeMortvielleFr/ManoirDeMortvielleFr.Slave
Marble Madness	M/Marble Madness	A-Games:M/MarbleMadness/MarbleMadness.slave
Maria's Xmas Box	M/Marias Xmas Box	A-Games:M/MariasXmasBox/MariasXmasBox.Slave
Marvin's Marvellous Adventure AGA	M/Marvins Marvellous Adventu	A-Games:M/MarvinsMarvellousAdvAGA/MarvinsMarvellousAdvAGA.Slave
Marvin's Marvellous Adventure CD32	M/Marvins Marvellous Adve V2	A-Games:M/MarvinsMarvellousAdvCD32/MarvinsMarvellousAdvCD32.Slave
Master Axe: The Genesis of MysterX	M/Master Axe The Genesis of	A-Games:M/MasterAxe/MasterAxe.slave
Master Blaster	M/Master Blaster	A-Games:M/MasterBlaster/MasterBlaster.Slave
Masterblazer	M/Masterblazer	A-Games:M/Masterblazer/Masterblazer.Slave
Match of the Day	M/Match of the Day	A-Games:M/MatchOfTheDay/MatchOfTheDay.Slave
Math Wizard	M/Math Wizard	A-Games:M/MathWizard/MathWizard.Slave
Matrix Marauders	M/Matrix Marauders	A-Games:M/MatrixMarauders/MatrixMarauders.slave
Maupiti Island	M/Maupiti Island	A-Games:M/MaupitiIsland/MaupitiIsland.Slave
Maupiti Island DE	M/Maupiti Island DE	A-Games:M/MaupitiIslandDe/MaupitiIslandDe.Slave
Maupiti Island ES	M/Maupiti Island ES	A-Games:M/MaupitiIslandEs/MaupitiIslandEs.Slave
Maupiti Island FR	M/Maupiti Island FR	A-Games:M/MaupitiIslandFr/MaupitiIslandFr.Slave
Max Rally	M/Max Rally	A-Games:M/MaxRally/MaxRally.slave
Mayday Squad	M/Mayday Squad	A-Games:M/MaydaySquadHeroes/MaydaySquadHeroes.Slave
McDonald Land	M/McDonald Land	A-Games:M/McDonaldLand/McDonaldLand.slave
McDonald Land	M/McDonald Land 	A-Games:M/McDonaldLandV2/McDonaldLandV2.slave
Mean Arenas	M/Mean Arenas	A-Games:M/MeanArenas/MeanArenas.slave
Mean Arenas CD32	M/Mean Arenas CD32	A-Games:M/MeanArenasCD32/MeanArenasCD32.slave
Mean Machine	M/Mean Machine	A-Games:M/MeanMachine/MeanMachine.slave
Mean Streets	M/Mean Streets	A-Games:M/MeanStreets/MeanStreets.slave
Mean Streets DE	M/Mean Streets DE	A-Games:M/MeanStreetsDe/MeanStreetsDe.slave
Mean Streets FR	M/Mean Streets FR	A-Games:M/MeanStreetsFr/MeanStreetsFr.slave
Megaball	M/Megaball	A-Games:M/MegaBall/MegaBall.slave
Megaball 1MB	M/Megaball 1MB	A-Games:M/MegaBall1MB/Megaball1MB.slave
Megaball AGA	M/Megaball AGA	A-Games:M/MegaBallAGA/MegaBallAGA.slave
Mega Block 2 (Beta/Unreleased)	M/Mega Block 2 BetaUnrelease	A-GamesBeta:M/MegaBlock2/MegaBlock2.Slave
Mega lo Mania	M/Mega lo Mania	A-Games:M/MegaLoMania/MegaLoMania.Slave
Mega lo Mania DE	M/Mega lo Mania DE	A-Games:M/MegaLoManiaDe/MegaLoManiaDe.Slave
Mega lo Mania FR	M/Mega lo Mania FR	A-Games:M/MegaLoManiaFr/MegaLoManiaFr.Slave
Mega Motion	M/Mega Motion	A-Games:M/MegaMotion/MegaMotion.slave
Mega Phoenix	M/Mega Phoenix	A-Games:M/MegaPhoenix/MegaPhoenix.Slave
MegaTraveller 1: The Zhodani Conspiracy	M/MegaTraveller 1 The Zhodan	A-Games:M/MegaTraveller1/MegaTraveller1.Slave
Mega Twins	M/Mega Twins	A-Games:M/MegaTwins/MegaTwins.slave
Mega Typhoon	M/Mega Typhoon	A-Games:M/MegaTyphoon/MegaTyphoon.slave
Menace	M/Menace	A-Games:M/Menace/Menace.Slave
Mental Image Game Disk Image1	M/Mental Image Game Disk Ima	A-Games:M/MentalImage1/MentalImage1.Slave
Mental Image Game Disk Image2	M/Mental Image Game Disk  V2	A-Games:M/MentalImage2/MentalImage2.slave
Mentor PL	M/Mentor PL	A-Games:M/MentorPl/MentorPl.Slave
Mercenary I: Escape from Targ and the Second City	M/Mercenary I Escape from Ta	A-Games:M/Mercenary/Mercenary.slave
Mercenary III: The Dion Crisis	M/Mercenary III The Dion Cri	A-Games:M/Mercenary3/Mercenary3.Slave
Mercs	M/Mercs	A-Games:M/Mercs/Mercs.Slave
Merv the Merciless	M/Merv the Merciless	A-Games:M/MervTheMerciless/MervTheMerciless.slave
Metal Gear	M/Metal Gear	A-Games:M/MetalGear/MetalGear.Slave
Metal Law	M/Metal Law	A-Games:M/MetalLaw/MetalLaw.slave
Metal Masters	M/Metal Masters	A-Games:M/MetalMasters/MetalMasters.Slave
Metal Mutant	M/Metal Mutant	A-Games:M/MetalMutant/MetalMutant.slave
Metal Mutant DE	M/Metal Mutant DE	A-Games:M/MetalMutantDe/MetalMutantDe.slave
Metal Mutant FR	M/Metal Mutant FR	A-Games:M/MetalMutantFr/MetalMutantFr.slave
Metal Warrior	M/Metal Warrior	A-Games:M/MetalWarrior/MetalWarrior.Slave
Metro-Cross	M/Metro-Cross	A-Games:M/MetroCross/MetroCross.Slave
Mewilo DE	M/Mewilo DE	A-Games:M/MewiloDe/MewiloDe.Slave
Mewilo FR	M/Mewilo FR	A-Games:M/MewiloFr/MewiloFr.Slave
MF Tanks	M/MF Tanks	A-Games:M/MFTanks/MFTanks.Slave
Miami Chase	M/Miami Chase	A-Games:M/MiamiChase/MiamiChase.slave
Mickey's 123's: The BIG Surprise Party FR	M/Mickeys 123s The BIG Surpr	A-Games:M/Mickey123Fr/Mickey123Fr.Slave
Mickey ABC: Une journée à la fête FR	M/Mickey ABC Une journee a l	A-Games:M/MickeyABCFr/MickeyABCFr.Slave
Mickey Jeu De Memoire FR	M/Mickey Jeu De Memoire FR	A-Games:M/MickeyJeuDeMemoireFr/MickeyJeuDeMemoireFr.Slave
Mickey Mouse	M/Mickey Mouse	A-Games:M/MickeyMouseComputerGame/MickeyMouseComputerGame.Slave
Mickey - Puzzles Animes FR	M/Mickey - Puzzles Animes FR	A-Games:M/MickeyPuzzlesAnimesFr/MickeyPuzzlesAnimesFr.Slave
Mickey's ABC's: A Day at the Fair	M/Mickeys ABCs A Day at the	A-Games:M/MickeysABCs/MickeysABCs.Slave
Mickey's Jigsaw Puzzles	M/Mickeys Jigsaw Puzzles	A-Games:M/MickeysJigsawPuzzles/MickeysJigsawPuzzles.Slave
Mickey's Memory Challenge	M/Mickeys Memory Challenge	A-Games:M/MickeysMemoryChallenge/MickeysMemoryChallenge.Slave
Microbes	M/Microbes	A-Games:M/Microbes/Microbes.Slave
Micro Machines	M/Micro Machines	A-Games:M/MicroMachines/MicroMachines.slave
MicroProse Golf	M/MicroProse Golf	A-Games:M/MicroProseGolf/MicroProseGolf.slave
MicroProse Soccer	M/MicroProse Soccer	A-Games:M/MicroProseSoccer/MicroProseSoccer.Slave
Midnight Resistance	M/Midnight Resistance	A-Games:M/MidnightResistance/MidnightResistance.Slave
Midwinter	M/Midwinter	A-Games:M/Midwinter/Midwinter.Slave
Midwinter II: Flames of Freedom	M/Midwinter II Flames of Fre	A-Games:M/Midwinter2/Midwinter2.Slave
Midwinter II: Flames of Freedom DE	M/Midwinter II Flames of  V2	A-Games:M/Midwinter2De/Midwinter2De.Slave
Midwinter II: Flames of Freedom FR	M/Midwinter II Flames of  V3	A-Games:M/Midwinter2Fr/Midwinter2Fr.Slave
Midwinter DE	M/Midwinter DE	A-Games:M/MidwinterDe/MidwinterDe.Slave
Midwinter FR	M/Midwinter FR	A-Games:M/MidwinterFr/MidwinterFr.Slave
MiG-29 Fulcrum	M/MiG-29 Fulcrum	A-Games:M/MiG29Fulcrum/MiG29Fulcrum.Slave
MiG-29M Super Fulcrum	M/MiG-29M Super Fulcrum	A-Games:M/MiG29MSuperFulcrum/MiG29MSuperFulcrum.Slave
MIG-29 Soviet Fighter	M/MIG-29 Soviet Fighter	A-Games:M/MiG29SovietFighter/MiG29SovietFighter.Slave
Might and Magic II: Gates to Another World	M/Might and Magic II Gates t	A-Games:M/Might&Magic2/Might&Magic2.Slave
Might and Magic III: Isles of Terra	M/Might and Magic III Isles	A-Games:M/Might&Magic3/Might&Magic3.Slave
Might and Magic III: Isles of Terra DE	M/Might and Magic III Isles 	A-Games:M/Might&Magic3De/Might&Magic3De.Slave
Mighty Bombjack	M/Mighty Bombjack	A-Games:M/MightyBombJack/MightyBombjack.Slave
Mike Read's Computer Pop Quiz	M/Mike Reads Computer Pop Qu	A-Games:M/MikeReadsComputerPopQuiz/MikeReadsComputerPopQuiz.Slave
Mikro Mortal Tennis	M/Mikro Mortal Tennis	A-Games:M/MikroMortalTennis/MikroMortalTennis.Slave
Millennium 2.2 NTSC	M/Millennium 2.2 NTSC	A-Games:M/MilleniumNTSC/MilleniumNTSC.Slave
Millennium 2.2	M/Millennium 2.2	A-Games:M/Millennium22/Millennium22.Slave
Mindbender	M/Mindbender	A-Games:M/Mindbender/Mindbender.Slave
Mindfighter	M/Mindfighter	A-Games:M/Mindfighter/Mindfighter.Slave
Mindroll	M/Mindroll	A-Games:M/Mindroll/Mindroll.Slave
Mindshadow	M/Mindshadow	A-Games:M/Mindshadow/Mindshadow.Slave
Mind Walker NTSC	M/Mind Walker NTSC	A-Games:M/MindWalkerNTSC/MindWalkerNTSC.slave
Mini Golf	M/Mini Golf	A-Games:M/MiniGolf/MiniGolf.Slave
Mini Golf Plus	M/Mini Golf Plus	A-Games:M/MiniGolfPlus/MiniGolfPlus.slave
Minos	M/Minos	A-Games:M/Minos/Minos.Slave
Minskies ... The Abduction	M/Minskies ... The Abduction	A-Games:M/Minskies/Minskies.slave
Minskies ... The Abduction AGA	M/Minskies ... The Abduct V2	A-Games:M/MinskiesAGA/MinskiesAGA.slave
Misja Harolda: Zaginiony w systemie PL	M/Misja Harolda Zaginiony w	A-Games:M/MisjaHaroldaPl/MisjaHaroldaPl.slave
Missiles over Xerion	M/Missiles over Xerion	A-Games:M/MissilesOverXerion/MissilesOverXerion.slave
Mission Elevator	M/Mission Elevator	A-Games:M/MissionElevator/MissionElevator.slave
Mixed-Up Mother Goose	M/Mixed-Up Mother Goose	A-Games:M/MixedUpMotherGoose/MixedUpMotherGoose.Slave
Moebius NTSC	M/Moebius NTSC	A-Games:M/MoebiusNTSC/MoebiusNTSC.Slave
Monkey Business (Beta/Unreleased)	M/Monkey Business BetaUnrele	A-GamesBeta:M/MonkeyBusiness/MonkeyBusiness.slave
Monkey Island 2: LeChuck's Revenge	M/Monkey Island 2 LeChucks R	A-Games:M/MonkeyIsland2/MonkeyIsland2.slave
Monkey Island 2: LeChuck's Revenge DE	M/Monkey Island 2 LeChuck V2	A-Games:M/MonkeyIsland2De/MonkeyIsland2De.slave
Monkey Island 2: LeChuck's Revenge ES	M/Monkey Island 2 LeChuck V3	A-Games:M/MonkeyIsland2Es/MonkeyIsland2Es.slave
Monkey Island 2: LeChuck's Revenge FR	M/Monkey Island 2 LeChuck V4	A-Games:M/MonkeyIsland2Fr/MonkeyIsland2Fr.slave
Monkey Island 2: LeChuck's Revenge IT	M/Monkey Island 2 LeChuck V5	A-Games:M/MonkeyIsland2It/MonkeyIsland2It.slave
Monster Business	M/Monster Business	A-Games:M/MonsterBusiness/MonsterBusiness.slave
Monty Python's Flying Circus	M/Monty Pythons Flying Circu	A-Games:M/MontyPythonsFlyCir/MontyPythonsFlyCir.Slave
Monty Python's Flying Circus NTSC	M/Monty Pythons Flying Ci V2	A-Games:M/MontyPythonsFlyCirNTSC/MontyPythonsFlyCirNTSC.Slave
Moochies, The	M/Moochies. The	A-Games:M/Moochies/Moochies.Slave
Moon Blaster FR	M/Moon Blaster FR	A-Games:M/MoonBlasterFr/MoonBlasterFr.Slave
MoonFall	M/MoonFall	A-Games:M/Moonfall/Moonfall.slave
Moonshine Racers	M/Moonshine Racers	A-Games:M/MoonShineRacers/MoonShineRacers.Slave
Moonstone: A Hard Days Knight	M/Moonstone A Hard Days Knig	A-Games:M/Moonstone/Moonstone.Slave
Moonwalker	M/Moonwalker	A-Games:M/Moonwalker/Moonwalker.Slave
Morph	M/Morph	A-Games:M/Morph/Morph.Slave
Morph AGA	M/Morph AGA	A-Games:M/MorphAGA/MorphAGA.Slave
Morph CD32	M/Morph CD32	A-Games:M/MorphCD32/MorphCD32.Slave
Mortal Kombat	M/Mortal Kombat	A-Games:M/MortalKombat/MortalKombat.Slave
Mortal Kombat II 1MB	M/Mortal Kombat II 1MB	A-Games:M/MortalKombat21MB/MortalKombat21MB.slave
Mortal Kombat II 2MB	M/Mortal Kombat II 2MB	A-Games:M/MortalKombat22MB/MortalKombat22MB.slave
Mortal Kombat Censored	M/Mortal Kombat Censored	A-Games:M/MortalKombatCensored/MortalKombatCensored.Slave
Morton Strikes Back	M/Morton Strikes Back	A-Games:M/MortonStrikesBack/MortonStrikesBack.Slave
Morton Strikes Back AGA	M/Morton Strikes Back AGA	A-Games:M/MortonStrikesBackAGA/MortonStrikesBackAGA.Slave
Mortville Manor	M/Mortville Manor	A-Games:M/MortvilleManor/MortvilleManor.Slave
Mot	M/Mot	A-Games:M/Mot/Mot.slave
Motorbike Madness	M/Motorbike Madness	A-Games:M/MotorbikeMadness/MotorbikeMadness.Slave
Motörhead	M/Motorhead	A-Games:M/Motorhead/Motorhead.Slave
Motor Massacre	M/Motor Massacre	A-Games:M/MotorMassacre/MotorMassacre.Slave
MouseQuest NTSC	M/MouseQuest NTSC	A-Games:M/MouseQuestNTSC/MouseQuestNTSC.Slave
Mousetrap	M/Mousetrap	A-Games:M/Mousetrap/Mousetrap.Slave
Mr Blobby	M/Mr Blobby	A-Games:M/MrBlobby/MrBlobby.slave
Mr. HELI	M/Mr. HELI	A-Games:M/MrHeli/MrHeli.slave
Mr. Men Olympics, The (Beta/Unreleased)	M/Mr. Men Olympics. The Beta	A-GamesBeta:M/MrMenOlympics/MrMenOlympics.slave
Mr. Nutz	M/Mr. Nutz	A-Games:M/MrNutz/MrNutz.Slave
Ms. Pacman (Beta/Unreleased)	M/Ms. Pacman BetaUnreleased	A-GamesBeta:M/MsPacMan/MsPacMan.slave
M.U.D.S.	M/M.U.D.S.	A-Games:M/MUDS/MUDS.slave
Multi Player Soccer Manager	M/Multi Player Soccer Manage	A-Games:M/MultiPlayerSoccerManager/MultiPlayerSoccerManager.Slave
Munsters, The	M/Munsters. The	A-Games:M/Munsters/Munsters.slave
Murder	M/Murder	A-Games:M/Murder/Murder.Slave
Murders in Space Files	M/Murders in Space Files	A-Games:M/MurdersInSpaceFiles/MurdersInSpaceFiles.slave
Murders in Space Image	M/Murders in Space Image	A-Games:M/MurdersInSpaceImage/MurdersInSpaceImage.slave
Mysterious Worlds	M/Mysterious Worlds	A-Games:M/MysteriousWorlds/MysteriousWorlds.Slave
Mystery of the Mummy	M/Mystery of the Mummy	A-Games:M/MysteryOfTheMummy/MysteryOfTheMummy.Slave
Mystical	M/Mystical	A-Games:M/Mystical/Mystical.Slave
Myth	M/Myth	A-Games:M/MythMagneticScrolls/MythMagneticScrolls.Slave
Myth	M/Myth 	A-Games:M/MythSystem3/MythSystem3.slave
Myth CD32	M/Myth CD32	A-Games:M/MythSystem3CD32/MythSystem3CD32.slave