L'Aigle d'or : le Retour FR 512K	L/LAigle dor le Retour FR 51	A-Games:A/AigleDOr512kFr/AigleDOr512kFr.Slave
L'Aigle d'or : le Retour FR	L/LAigle dor le Retour FR	A-Games:A/AigleDOrFr/AigleDOrFr.Slave
Les Castors Juniors dans la Forêt FR	L/Les Castors Juniors dans l	A-Games:C/CastorsJuniorsFr/CastorsJuniorsFr.Slave
La Aventura Espacial ES	L/La Aventura Espacial ES	A-Games:L/LaAventuraEspacialEs/LaAventuraEspacialEs.slave
La Aventura Original ES	L/La Aventura Original ES	A-Games:L/LaAventuraOriginalEs/LaAventuraOriginalEs.slave
Labyrinth DK	L/Labyrinth DK	A-Games:L/LabyrinthDetNyeCOMputerDk/LabyrinthDetNyeCOMputerDk.slave
Labyrinthe D'Anglomania 1 FR	L/Labyrinthe DAnglomania 1 F	A-Games:L/LabyrintheDAnglomania1Fr/LabyrintheDAnglomania1Fr.Slave
Labyrinthe D'Anglomania 2 FR	L/Labyrinthe DAnglomania 2 F	A-Games:L/LabyrintheDAnglomania2Fr/LabyrintheDAnglomania2Fr.Slave
Labyrinthe de Lexicos, Le FR	L/Labyrinthe de Lexicos. Le	A-Games:L/LabyrintheDeLexicosFr/LabyrintheDeLexicosFr.Slave
Labyrinthe D'Errare, Le FR	L/Labyrinthe DErrare. Le FR	A-Games:L/LabyrintheDErrareFr/LabyrintheDErrareFr.Slave
Le Labyrinthe d'Orthophus FR	L/Le Labyrinthe dOrthophus F	A-Games:L/LabyrintheDOrthophusFr/LabyrintheDOrthophusFr.Slave
Labyrinthe Aux Mille Calculs, Le FR	L/Labyrinthe Aux Mille Calcu	A-Games:L/LabyrintheMilleCalculsFr/LabyrintheMilleCalculsFr.Slave
Labyrinthe de la Reine des Ombres, Le FR	L/Labyrinthe de la Reine des	A-Games:L/LabyrintheReineOmbresFr/LabyrintheReineOmbresFr.Slave
Lamborghini American Challenge	L/Lamborghini American Chall	A-Games:L/LamborghiniAmericanChllng/LamborghiniAmericanChllng.slave
Lancelot	L/Lancelot	A-Games:L/Lancelot/Lancelot.Slave
Landsitz von Mortville, Der DE	L/Landsitz von Mortville. De	A-Games:L/LandsitzVonMortvilleDe/LandsitzVonMortVilleDe.Slave
Laser Squad	L/Laser Squad	A-Games:L/LaserSquad/LaserSquad.slave
Laser Squad IT	L/Laser Squad IT	A-Games:L/LaserSquadIt/LaserSquadIt.slave
Laser Squad NTSC	L/Laser Squad NTSC	A-Games:L/LaserSquadNTSC/LaserSquadNTSC.slave
Last Action Hero	L/Last Action Hero	A-Games:L/LastActionHero/LastActionHero.Slave
Last Battle	L/Last Battle	A-Games:L/LastBattle/LastBattle.Slave
Last Duel	L/Last Duel	A-Games:L/LastDuel/LastDuel.slave
Last Ninja 2	L/Last Ninja 2	A-Games:L/LastNinja2/LastNinja2.slave
Last Ninja 3	L/Last Ninja 3	A-Games:L/LastNinja3/LastNinja3.Slave
Last Ninja 3 CD32	L/Last Ninja 3 CD32	A-Games:L/LastNinja3CD32/LastNinja3CD32.Slave
Last Soldier, The PL	L/Last Soldier. The PL	A-Games:L/LastSoldierPl/LastSoldierPl.slave
Leader Board	L/Leader Board	A-Games:L/LeaderBoard/Leaderboard.slave
Leader Board Tournament	L/Leader Board Tournament	A-Games:L/LeaderBoardTD1/LeaderboardTD1.slave
Leading Lap MPV	L/Leading Lap MPV	A-Games:L/LeadingLapMPV/LeadingLapMPV.Slave
Leading Lap MPV AGA	L/Leading Lap MPV AGA	A-Games:L/LeadingLapMPVAGA/LeadingLapMPVAGA.slave
Leading Lap MPV AGA CUAmiga	L/Leading Lap MPV AGA CUAmig	A-Games:L/LeadingLapMPVAGACUAmiga/LeadingLapMPVAGACUAmiga.slave
Leading Lap MPV CUAmiga	L/Leading Lap MPV CUAmiga	A-Games:L/LeadingLapMPVCUAmiga/LeadingLapMPVCUAmiga.Slave
Leander	L/Leander	A-Games:L/Leander/Leander.slave
Leander NTSC	L/Leander NTSC	A-Games:L/LeanderNTSC/LeanderNTSC.slave
Leatherneck	L/Leatherneck	A-Games:L/Leatherneck/Leatherneck.Slave
Leavin' Teramis	L/Leavin Teramis	A-Games:L/LeavinTeramis/LeavinTeramis.Slave
LED Storm	L/LED Storm	A-Games:L/LEDStorm/LEDStorm.slave
Legacy	L/Legacy	A-Games:L/Legacy/Legacy.Slave
Legacy NoIntro	L/Legacy NoIntro	A-Games:L/LegacyNoIntro/LegacyNoIntro.slave
Legend getlegendsavedisk	L/Legend getlegendsavedisk	A-Games:L/LegendMindscape/getlegendsavedisk.slave
Legend	L/Legend	A-Games:L/LegendMindscape/LegendMindscape.Slave
Legend of Djel	L/Legend of Djel	A-Games:L/LegendOfDjel/LegendOfDjel.Slave
Legend of Djel DE	L/Legend of Djel DE	A-Games:L/LegendOfDjelDe/LegendOfDjelDe.Slave
Legend of Faerghail	L/Legend of Faerghail	A-Games:L/LegendOfFaerghail/LegendOfFaerghail.slave
Legend of Faerghail DE	L/Legend of Faerghail DE	A-Games:L/LegendOfFaerghailDe/LegendOfFaerghailDe.slave
Legend of Faerghail NTSC	L/Legend of Faerghail NTSC	A-Games:L/LegendOfFaerghailNTSC/LegendOfFaerghailNTSC.slave
Legend of Kyrandia	L/Legend of Kyrandia	A-Games:L/LegendOfKyrandia/LegendOfKyrandia.Slave
Legend of Kyrandia DE	L/Legend of Kyrandia DE	A-Games:L/LegendOfKyrandiaDe/LegendOfKyrandiaDe.Slave
Legend of Kyrandia FR	L/Legend of Kyrandia FR	A-Games:L/LegendOfKyrandiaFr/LegendOfKyrandiaFr.Slave
Legend of Kyrandia IT	L/Legend of Kyrandia IT	A-Games:L/LegendOfKyrandiaIt/LegendOfKyrandiaIt.Slave
Legend of the Lost	L/Legend of the Lost	A-Games:L/LegendOfTheLost/LegendOfTheLost.slave
Legend of the Sword	L/Legend of the Sword	A-Games:L/LegendOfTheSword/LegendOfTheSword.slave
Legends AGA	L/Legends AGA	A-Games:L/LegendsAGA/LegendsAGA.Slave
Legends CD32	L/Legends CD32	A-Games:L/LegendsCD32/LegendsCD32.Slave
Legends of Valour	L/Legends of Valour	A-Games:L/LegendsOfValour/LegendsOfValour.Slave
Legends of Valour DE	L/Legends of Valour DE	A-Games:L/LegendsOfValourDe/LegendsOfValourDe.Slave
Legends of Valour FR	L/Legends of Valour FR	A-Games:L/LegendsOfValourFr/LegendsOfValourFr.Slave
Legion (Beta/Unreleased)	L/Legion BetaUnreleased	A-Beta:L/Legion/Legion.Slave
Legion PL	L/Legion PL	A-Games:L/LegionPl/LegionPl.Slave
Legions of Dawn	L/Legions of Dawn	A-Games:L/LegionsOfDawn/LegionsOfDawn.Slave
Leisure Suit Larry	L/Leisure Suit Larry	A-Games:L/LeisureSuitLarry/LeisureSuitLarry.slave
Leisure Suit Larry 2	L/Leisure Suit Larry 2	A-Games:L/LeisureSuitLarry2/LeisureSuitLarry2.Slave
Leisure Suit Larry 3	L/Leisure Suit Larry 3	A-Games:L/LeisureSuitLarry3/LeisureSuitLarry3.Slave
Leisure Suit Larry 3 DE	L/Leisure Suit Larry 3 DE	A-Games:L/LeisureSuitLarry3De/LeisureSuitLarry3De.Slave
Leisure Suit Larry 5: Passionate Patti does a Little Undercover Work	L/Leisure Suit Larry 5 Passi	A-Games:L/LeisureSuitLarry5/LeisureSuitLarry5.Slave
Leisure Suit Larry 5: Passionate Patti does a Little Undercover Work DE	L/Leisure Suit Larry 5 Pa V2	A-Games:L/LeisureSuitLarry5De/LeisureSuitLarry5De.Slave
Leisure Suit Larry 5: Passionate Patti does a Little Undercover Work	L/Leisure Suit Larry 5 Pa V3	A-Games:L/LeisureSuitLarry5DeMT32/LeisureSuitLarry5DeMT32.Slave
Leisure Suit Larry 5: Passionate Patti does a Little Undercover Work	L/Leisure Suit Larry 5 Pa V4	A-Games:L/LeisureSuitLarry5MT32/LeisureSuitLarry5MT32.Slave
Leisure Suit Larry in the Land of the Lounge Lizards	L/Leisure Suit Larry in the	A-Games:L/LeisureSuitLarryEnhanced/LeisureSuitLarryEnhanced.slave
Leisure Suit Larry in the Land of the Lounge Lizards	L/Leisure Suit Larry in the 	A-Games:L/LeisureSuitLarryEnhndMT32/LeisureSuitLarryEnhndMT32.slave
Lemmings 2: The Tribes 1MB	L/Lemmings 2 The Tribes 1MB	A-Games:L/Lemmings21MB/Lemmings21MB.slave
Lemmings 2: The Tribes 1MB NTSC	L/Lemmings 2 The Tribes 1MB 	A-Games:L/Lemmings21MBNTSC/Lemmings21MBNTSC.slave
Lemmings 2: The Tribes 512KB	L/Lemmings 2 The Tribes 512K	A-Games:L/Lemmings2512KB/Lemmings2512KB.slave
Lemmings 2: The Tribes 512KB NTSC	L/Lemmings 2 The Tribes 5 V2	A-Games:L/Lemmings2512KBNTSC/Lemmings2512KBNTSC.slave
Lemmings 2: The Tribes Demo	L/Lemmings 2 The Tribes Demo	A-Games:L/Lemmings2Demo/Lemmings2Demo.Slave
Lemmings Files Alt	L/Lemmings Files Alt	A-Games:L/LemmingsAltFiles/LemmingsAltFiles.Slave
Lemmings Image Alt	L/Lemmings Image Alt	A-Games:L/LemmingsAltImage/LemmingsAltImage.Slave
Lemmings CDTV	L/Lemmings CDTV	A-Games:L/LemmingsCDTV/LemmingsCDTV.Slave
Lemmings Demo	L/Lemmings Demo	A-Games:L/LemmingsDemo/LemmingsDemo.Slave
Lemmings Files	L/Lemmings Files	A-Games:L/LemmingsFiles/LemmingsFiles.Slave
Lemmings NTSC Files	L/Lemmings NTSC Files	A-Games:L/LemmingsFilesNTSC/LemmingsFilesNTSC.Slave
Lemmings Image	L/Lemmings Image	A-Games:L/LemmingsImage/LemmingsImage.Slave
Lemmings NTSC Image	L/Lemmings NTSC Image	A-Games:L/LemmingsImageNTSC/LemmingsImageNTSC.Slave
Leonardo	L/Leonardo	A-Games:L/LeonardoDOS/LeonardoDOS.Slave
Leonardo	L/Leonardo 	A-Games:L/LeonardoHighDensity/LeonardoHighDensity.Slave
Les Manley in Search for the King	L/Les Manley in Search for t	A-Games:L/LesManleySearchForTheKing/LesManleySearchForTheKing.slave
Lethal Weapon	L/Lethal Weapon	A-Games:L/LethalWeapon/LethalWeapon.Slave
Lethal Xcess	L/Lethal Xcess	A-Games:L/LethalXcess/LethalXcess.slave
Lethal Zone	L/Lethal Zone	A-Games:L/LethalZone/LethalZone.slave
Lettrix DE	L/Lettrix DE	A-Games:L/LettrixDe/LettrixDe.Slave
Leviathan	L/Leviathan	A-Games:L/Leviathan/Leviathan.Slave
Liberation (Beta/Unreleased)	L/Liberation BetaUnreleased	A-Beta:L/Liberation/Liberation.Slave
Liberation CD32 (Beta/Unreleased)	L/Liberation CD32 BetaUnrele	A-Beta:L/LiberationCD32/LiberationCD32.Slave
Licence to Kill	L/Licence to Kill	A-Games:L/LicenceToKill/LicenceToKill.Slave
Life & Death	L/Life Death	A-Games:L/Life&Death/Life&Death.slave
Light Corridor, The	L/Light Corridor. The	A-Games:L/LightCorridor/LightCorridor.Slave
Light Racer DE	L/Light Racer DE	A-Games:L/LightRacerDe/LightRacerDe.Slave
Limes & Napoleon	L/Limes Napoleon	A-Games:L/Limes&Napoleon/Limes&Napoleon.Slave
Line of Fire	L/Line of Fire	A-Games:L/LineOfFire/LineOfFire.slave
Links: The Challenge of Golf	L/Links The Challenge of Gol	A-Games:L/Links/Links.slave
Links: The Challenge of Golf DataDisk	L/Links The Challenge of  V2	A-Games:L/Links&DataDisks/Links&DataDisks.Slave
Links: The Challenge of Golf DataDisk NTSC	L/Links The Challenge of  V3	A-Games:L/Links&DataDisksNTSC/Links&DataDisksNTSC.Slave
Links: The Challenge of Golf NTSC	L/Links The Challenge of  V4	A-Games:L/LinksNTSC/LinksNTSC.slave
Lionheart	L/Lionheart	A-Games:L/Lionheart/Lionheart.slave
Lionheart Demo	L/Lionheart Demo	A-Games:L/LionheartDemo/LionheartDemo.Slave
Lionheart 1MB Demo	L/Lionheart 1MB Demo	A-Games:L/LionheartDemo1MB/LionheartDemo1MB.slave
Lion King, The AGA	L/Lion King. The AGA	A-Games:L/LionKingAGA/LionKingAGA.Slave
Liquid Kids Files	L/Liquid Kids Files	A-Games:L/LiquidKidsFiles/LiquidKidsFiles.Slave
Liquid Kids Image	L/Liquid Kids Image	A-Games:L/LiquidKidsImage/LiquidKidsImage.Slave
Little Computer People	L/Little Computer People	A-Games:L/LittleComputerPeople/LittleComputerPeople.Slave
Little Computer People NTSC	L/Little Computer People NTS	A-Games:L/LittleComputerPeopleNTSC/LittleComputerPeopleNTSC.Slave
Little Puff in Dragonland	L/Little Puff in Dragonland	A-Games:L/LittlePuffInDragonland/LittlePuffInDragonland.slave
Little Red Riding Hood	L/Little Red Riding Hood	A-Games:L/LittleRedRidingHood/LittleRedRidingHood.Slave
Live and Let Die	L/Live and Let Die	A-Games:L/LiveAndLetDie/LiveAndLetDie.Slave
Liverpool: The Computer Game	L/Liverpool The Computer Gam	A-Games:L/Liverpool/Liverpool.Slave
Livingstone II	L/Livingstone II	A-Games:L/Livingstone2/Livingstone2.Slave
Llamatron: 2112 1MB	L/Llamatron 2112 1MB	A-Games:L/Llamatron1MB/Llamatron1MB.Slave
Llamatron: 2112 512KB	L/Llamatron 2112 512KB	A-Games:L/Llamatron512KB/Llamatron512KB.Slave
Locomotion	L/Locomotion	A-Games:L/Locomotion/Locomotion.Slave
Logical	L/Logical	A-Games:L/Logical/Logical.slave
Logical CDTV	L/Logical CDTV	A-Games:L/LogicalCDTV/LogicalCDTV.slave
Logo	L/Logo	A-Games:L/Logo/Logo.Slave
Lollypop	L/Lollypop	A-Games:L/Lollypop/Lollypop.Slave
Lombard RAC Rally 1Disk	L/Lombard RAC Rally 1Disk	A-Games:L/LombardRACRally1Disk/LombardRACRally1Disk.Slave
Lombard RAC Rally DE 1Disk	L/Lombard RAC Rally DE 1Disk	A-Games:L/LombardRACRally1DiskDe/LombardRACRally1DiskDe.Slave
Lombard RAC Rally 2Disk	L/Lombard RAC Rally 2Disk	A-Games:L/LombardRACRally2Disk/LombardRACRally2Disk.Slave
Lombard RAC Rally DE 2Disk	L/Lombard RAC Rally DE 2Disk	A-Games:L/LombardRACRally2DiskDe/LombardRACRally2DiskDe.Slave
Loom	L/Loom	A-Games:L/Loom/Loom.slave
Loom DE	L/Loom DE	A-Games:L/LoomDe/LoomDe.slave
Loom DE CDTV	L/Loom DE CDTV	A-Games:L/LoomDeCDTV/LoomDeCDTV.slave
Loom ES	L/Loom ES	A-Games:L/LoomEs/LoomEs.slave
Loom FR	L/Loom FR	A-Games:L/LoomFr/LoomFr.slave
Loom IT	L/Loom IT	A-Games:L/LoomIt/LoomIt.slave
Loopz	L/Loopz	A-Games:L/Loopz/Loopz.Slave
Lords of Chaos DataDisk	L/Lords of Chaos DataDisk	A-Games:L/LordsOfChaos&DataDisk/LordsOfChaos&DataDisk.Slave
Lords of Doom	L/Lords of Doom	A-Games:L/LordsOfDoom/LordsOfDoom.Slave
Lords of Doom DE	L/Lords of Doom DE	A-Games:L/LordsOfDoomDe/LordsOfDoomDe.Slave
Lords of the Realm	L/Lords of the Realm	A-Games:L/LordsOfTheRealm/LordsOfTheRealm.Slave
Lords of the Realm AGA	L/Lords of the Realm AGA	A-Games:L/LordsOfTheRealmAGA/LordsOfTheRealmAGA.Slave
Lords of the Realm DE AGA	L/Lords of the Realm DE AGA	A-Games:L/LordsOfTheRealmAGADe/LordsOfTheRealmAGADe.Slave
Lords of the Realm DE AGA FAST	L/Lords of the Realm DE AGA 	A-Games:L/LordsOfTheRealmAGADeFast/LordsOfTheRealmAGADeFast.Slave
Lords of the Realm AGA FAST	L/Lords of the Realm AGA FAS	A-Games:L/LordsOfTheRealmAGAFast/LordsOfTheRealmAGAFast.slave
Lords of the Realm FR AGA	L/Lords of the Realm FR AGA	A-Games:L/LordsOfTheRealmAGAFr/LordsOfTheRealmAGAFr.Slave
Lords of the Realm FR AGA FAST	L/Lords of the Realm FR AGA 	A-Games:L/LordsOfTheRealmAGAFrFast/LordsOfTheRealmAGAFrFast.slave
Lords of the Rising Sun	L/Lords of the Rising Sun	A-Games:L/LordsOfTheRisingSun/LordsOfTheRisingSun.slave
Lords of the Rising Sun NTSC	L/Lords of the Rising Sun NT	A-Games:L/LordsOfTheRisingSunNTSC/LordsOfTheRisingSunNTSC.slave
Lords of Time	L/Lords of Time	A-Games:L/LordsOfTime/LordsOfTime.Slave
Lords of War	L/Lords of War	A-Games:L/LordsOfWar/lordsOfwar.slave
Lorna	L/Lorna	A-Games:L/Lorna/Lorna.slave
Lost Dutchman Mine	L/Lost Dutchman Mine	A-Games:L/LostDutchmanMine/LostDutchmanMine.Slave
Lost in Mine PL	L/Lost in Mine PL	A-Games:L/LostInMinePl/LostInMinePl.slave
Lost Patrol, The	L/Lost Patrol. The	A-Games:L/LostPatrol/LostPatrol.Slave
Lost Patrol, The NTSC	L/Lost Patrol. The NTSC	A-Games:L/LostPatrolNTSC/LostPatrolNTSC.Slave
Lost Treasures Of Infocom, The (Beta/Unreleased)	L/Lost Treasures Of Infocom.	A-Beta:L/LostTreasuresOfInfocom/LostTreasuresOfInfocom.Slave
Lost Vikings, The	L/Lost Vikings. The	A-Games:L/LostVikings/LostVikings.Slave
Lost Vikings, The CD32	L/Lost Vikings. The CD32	A-Games:L/LostVikingsCD32/LostVikingsCD32.slave
Lost Vikings, The DE	L/Lost Vikings. The DE	A-Games:L/LostVikingsDe/LostVikingsDe.Slave
Lost Vikings, The Demo	L/Lost Vikings. The Demo	A-Games:L/LostVikingsDemo/LostVikingsDemo.Slave
Lost Vikings, The FR Demo	L/Lost Vikings. The FR Demo	A-Games:L/LostVikingsDemoFr/LostVikingsDemoFr.Slave
Lost Vikings, The FR	L/Lost Vikings. The FR	A-Games:L/LostVikingsFr/LostVikingsFr.Slave
Lothar Matthäus	L/Lothar Matthaus	A-Games:L/LotharMatthausFussball/LotharMatthausFussball.slave
Lothar Matthäus Super Soccer DE	L/Lothar Matthaus Super Socc	A-Games:L/LotharMSuperSoccerDe/LotharMSuperSoccerDe.Slave
Lotus Esprit Turbo Challenge	L/Lotus Esprit Turbo Challen	A-Games:L/Lotus/Lotus.Slave
Lotus Turbo Challenge 2	L/Lotus Turbo Challenge 2	A-Games:L/Lotus2/Lotus2.Slave
Lotus III: The Ultimate Challenge	L/Lotus III The Ultimate Cha	A-Games:L/Lotus3/Lotus3.slave
Lotus Esprit Turbo Challenge CD32	L/Lotus Esprit Turbo Chal V2	A-Games:L/LotusCD32/LotusCD32.Slave
Lunar-C CD32	L/Lunar-C CD32	A-Games:L/LunarCCD32/LunarCCD32.slave
Lupo Alberto	L/Lupo Alberto	A-Games:L/LupoAlberto/LupoAlberto.Slave
Lure of the Temptress	L/Lure of the Temptress	A-Games:L/LureOfTheTemptress/LureOfTheTemptress.Slave
Lure of the Temptress DE	L/Lure of the Temptress DE	A-Games:L/LureOfTheTemptressDe/LureOfTheTemptressDe.slave
Lure of the Temptress FR	L/Lure of the Temptress FR	A-Games:L/LureOfTheTemptressFr/LureOfTheTemptressFr.slave
Lure of the Temptress IT	L/Lure of the Temptress IT	A-Games:L/LureOfTheTemptressIt/LureOfTheTemptressIt.slave
Luxor	L/Luxor	A-Games:L/Luxor/Luxor.Slave
L'Uomo Ragno: Il ritorno di Hobgoblin	L/LUomo Ragno Il ritorno di	A-Games:S/Spiderman/Spiderman.Slave
L'Uomo Ragno: E ora, Carnage	L/LUomo Ragno E ora. Carnage	A-Games:S/Spiderman2/Spiderman2.Slave
L'Uomo Ragno: Destino Incrociato	L/LUomo Ragno Destino Incroc	A-Games:S/Spiderman3/Spiderman3.Slave
La Storia Ancestrale 4	L/La Storia Ancestrale 4	A-Games:S/StoriaAncestrale/StoriaAncestrale.Slave