Zak McKracken and the Alien Mindbenders	Z/Zak McKracken and the Alie	A-Games:Z/ZakMcKracken/ZakMcKracken.slave
Zak McKracken and the Alien Mindbenders DE	Z/Zak McKracken and the A V2	A-Games:Z/ZakMcKrackenDe/ZakMcKrackenDe.slave
Zak McKracken and the Alien Mindbenders FR	Z/Zak McKracken and the A V3	A-Games:Z/ZakMcKrackenFr/ZakMcKrackenFr.slave
Zak McKracken and the Alien Mindbenders IT	Z/Zak McKracken and the A V4	A-Games:Z/ZakMcKrackenIt/ZakMcKrackenIt.slave
Zany Golf NTSC	Z/Zany Golf NTSC	A-Games:Z/ZanyGolfNTSC/ZanyGolfNTSC.slave
Zarathrusta	Z/Zarathrusta	A-Games:Z/Zarathrusta/Zarathrusta.slave
Zaxxon 1MB	Z/Zaxxon 1MB	A-Games:Z/Zaxxon1MB/Zaxxon1MB.Slave
Zaxxon 512KB	Z/Zaxxon 512KB	A-Games:Z/Zaxxon512KB/Zaxxon512KB.Slave
Za Zelazna Brama PL	Z/Za Zelazna Brama PL	A-Games:Z/ZaZelaznaBramaPl/ZaZelaznaBramaPl.Slave
Zeewolf	Z/Zeewolf	A-Games:Z/Zeewolf/Zeewolf.slave
Zeewolf 2: Wild Justice	Z/Zeewolf 2 Wild Justice	A-Games:Z/Zeewolf2/Zeewolf2.Slave
Zero Gravity	Z/Zero Gravity	A-Games:Z/ZeroGravity/ZeroGravity.Slave
Ziriax	Z/Ziriax	A-Games:Z/Ziriax/Ziriax.slave
Ziriax	Z/Ziriax 	A-Games:Z/ZiriaxUltimateEdition/ZiriaxUltimateEdition.slave
Zombi	Z/Zombi	A-Games:Z/Zombi/Zombi.slave
Zombi DE	Z/Zombi DE	A-Games:Z/ZombiDe/ZombiDe.Slave
Zombie Apocalypse	Z/Zombie Apocalypse	A-Games:Z/ZombieApocalypse/ZombieApocalypse.Slave
Zombie Apocalypse II AGA	Z/Zombie Apocalypse II AGA	A-Games:Z/ZombieApocalypse2AGA/ZombieApocalypse2AGA.Slave
Zombi FR	Z/Zombi FR	A-Games:Z/ZombiFr/ZombiFr.Slave
Zone Warrior	Z/Zone Warrior	A-Games:Z/ZoneWarrior/ZoneWarrior.slave
Zool	Z/Zool	A-Games:Z/Zool/Zool.slave
Zool	Z/Zool 	A-Games:Z/Zool/Zool.slave
Zool 2	Z/Zool 2	A-Games:Z/Zool2/Zool2.Slave
Zool 2 AGA	Z/Zool 2 AGA	A-Games:Z/Zool2AGA/Zool2AGA.Slave
Zool AGA	Z/Zool AGA	A-Games:Z/ZoolAGA/ZoolAGA.slave
Zool AGA	Z/Zool AGA 	A-Games:Z/ZoolAGA/ZoolAGA.slave
Zool CD32	Z/Zool CD32	A-Games:Z/ZoolCD32/ZoolCD32.slave
Zool CD32 NTSC	Z/Zool CD32 NTSC	A-Games:Z/ZoolCD32NTSC/ZoolCD32NTSC.slave
Zoom!	Z/Zoom	A-Games:Z/Zoom/Zoom.Slave
Z-Out	Z/Z-Out	A-Games:Z/ZOut/ZOut.slave
Zyconix	Z/Zyconix	A-Games:Z/Zyconix/Zyconix.Slave
Zynaps	Z/Zynaps	A-Games:Z/Zynaps/Zynaps.slave