Ian Botham's Cricket	I/Ian Bothams Cricket	A-Games:I/IanBothamsCricket/IanBothamsCricket.Slave
Ice Runner	I/Ice Runner	A-Games:I/IceRunner/IceRunner.Slave
IK+	I/IK+	A-Games:I/IK+/IK+.slave
IK+ CD32	I/IK+ CD32	A-Games:I/IK+CD32/IK+CD32.slave
Ikari Warriors	I/Ikari Warriors	A-Games:I/IkariWarriors/IkariWarriors.Slave
Ilyad	I/Ilyad	A-Games:I/Ilyad/Ilyad.slave
Immortal, The	I/Immortal. The	A-Games:I/Immortal/Immortal.slave
Impact!	I/Impact	A-Games:I/Impact/Impact.Slave
Impact!	I/Impact 	A-Games:I/Impact95/Impact95.Slave
Imperium	I/Imperium	A-Games:I/Imperium/Imperium.Slave
Impossamole	I/Impossamole	A-Games:I/Impossamole/Impossamole.slave
Impossible Mission II	I/Impossible Mission II	A-Games:I/ImpossibleMission2/ImpossibleMission2.Slave
Impossible Mission 2025: The Special Edition	I/Impossible Mission 2025 Th	A-Games:I/ImpossibleMission2025/ImpossibleMission2025.slave
Impossible Mission 2025: The Special Edition AGA	I/Impossible Mission 2025 V2	A-Games:I/ImpossibleMission2025AGA/ImpossibleMission2025AGA.slave
Incredible Crash Dummies, The	I/Incredible Crash Dummies.	A-Games:I/IncredibleCrashDummies/IncredibleCrashDummies.slave
Indiana Jones and the Fate of Atlantis	I/Indiana Jones and the Fate	A-Games:I/IndianaJonesAtlantisAct/IndianaJonesAtlantisAct.slave
Indiana Jones and the Fate of Atlantis	I/Indiana Jones and the F V2	A-Games:I/IndianaJonesAtlantisAdv/IndianaJonesAtlantisAdv.slave
Indiana Jones and the Fate of Atlantis DE	I/Indiana Jones and the F V3	A-Games:I/IndianaJonesAtlantisAdvDe/IndianaJonesAtlantisAdvDe.slave
Indiana Jones and the Fate of Atlantis ES	I/Indiana Jones and the F V4	A-Games:I/IndianaJonesAtlantisAdvEs/IndianaJonesAtlantisAdvEs.slave
Indiana Jones and the Fate of Atlantis FR	I/Indiana Jones and the F V5	A-Games:I/IndianaJonesAtlantisAdvFr/IndianaJonesAtlantisAdvFr.slave
Indiana Jones and the Fate of Atlantis IT	I/Indiana Jones and the F V6	A-Games:I/IndianaJonesAtlantisAdvIt/IndianaJonesAtlantisAdvIt.slave
Indiana Jones and the Last Crusade	I/Indiana Jones and the Last	A-Games:I/IndianaJonesLastCrusAct/IndianaJonesLastCrusAct.Slave
Indiana Jones and the Last Crusade DE	I/Indiana Jones and the L V2	A-Games:I/IndianaJonesLastCrusAdvDe/IndianaJonesLastCrusAdvDe.slave
Indiana Jones and the Last Crusade ES	I/Indiana Jones and the L V3	A-Games:I/IndianaJonesLastCrusAdvEs/IndianaJonesLastCrusAdvEs.slave
Indiana Jones and the Last Crusade FR	I/Indiana Jones and the L V4	A-Games:I/IndianaJonesLastCrusAdvFr/IndianaJonesLastCrusAdvFr.slave
Indiana Jones and the Last Crusade IT	I/Indiana Jones and the L V5	A-Games:I/IndianaJonesLastCrusAdvIt/IndianaJonesLastCrusAdvIt.slave
Indiana Jones and the Temple of Doom	I/Indiana Jones and the Temp	A-Games:I/IndianaJonesTempleOfDoom/IndianaJonesTempleOfDoom.slave
Indianapolis 500	I/Indianapolis 500	A-Games:I/Indianapolis500/Indianapolis500.slave
Indigo Files	I/Indigo Files	A-Games:I/IndigoFiles/IndigoFiles.Slave
Indigo Image	I/Indigo Image	A-Games:I/IndigoImage/IndigoImage.Slave
Indoor Sports: Volume 1	I/Indoor Sports Volume 1	A-Games:I/IndoorSports/IndoorSports.Slave
Indy Heat	I/Indy Heat	A-Games:I/IndyHeat/IndyHeat.Slave
Indiana Jones and the Last Crusade NTSC	I/Indiana Jones and the L V6	A-Games:I/IndyJonesLastCrusAdvNTSC/IndyJonesLastCrusAdvNTSC.slave
Indiana Jones and the Last Crusade DE CDTV	I/Indiana Jones and the L V7	A-Games:I/IndyLastCrusAdvDeCDTV/IndyLastCrusAdvDeCDTV.slave
Inertia Drive	I/Inertia Drive	A-Games:I/InertiaDrive/InertiaDrive.Slave
Infection	I/Infection	A-Games:I/Infection/Infection.Slave
Infestation	I/Infestation	A-Games:I/Infestation/Infestation.slave
Ingrid's Back!	I/Ingrids Back	A-Games:I/IngridsBack/IngridsBack.Slave
Innocent Until Caught	I/Innocent Until Caught	A-Games:I/InnocentUntilCaught/InnocentUntilCaught.slave
Innocent Until Caught DE	I/Innocent Until Caught DE	A-Games:I/InnocentUntilCaughtDe/InnocentUntilCaughtDe.slave
Innocent Until Caught FR	I/Innocent Until Caught FR	A-Games:I/InnocentUntilCaughtFr/InnocentUntilCaughtFr.slave
Insanity Fight	I/Insanity Fight	A-Games:I/InsanityFight/InsanityFight.Slave
Insector Hecti in the Interchange	I/Insector Hecti in the Inte	A-Games:I/InsectorHectiInterChange/InsectorHectiInterChange.Slave
Insects in Space	I/Insects in Space	A-Games:I/InsectsInSpace/InsectsInSpace.slave
Intact 15MB	I/Intact 15MB	A-Games:I/Intact15MB/Intact15MB.Slave
Intact 1MB	I/Intact 1MB	A-Games:I/Intact1MB/Intact1MB.Slave
Intact 512KB	I/Intact 512KB	A-Games:I/Intact512KB/Intact512KB.Slave
International 3D Tennis	I/International 3D Tennis	A-Games:I/International3DTennis/International3DTennis.Slave
International Ice Hockey	I/International Ice Hockey	A-Games:I/InternationalIceHockey/InternationalIceHockey.Slave
International Ninja Rabbits	I/International Ninja Rabbit	A-Games:I/InternationalNinjaRabbits/InternationalNinjaRabbits.Slave
International Soccer	I/International Soccer	A-Games:I/InternationalSoccer/InternationalSoccer.Slave
International Tennis	I/International Tennis	A-Games:I/InternationalTennis/InternationalTennis.slave
International Truck Racing	I/International Truck Racing	A-Games:I/InternationalTruckRacing/InternationalTruckRacing.slave
Interphase	I/Interphase	A-Games:I/Interphase/Interphase.slave
Interphase AmigaFormat	I/Interphase AmigaFormat	A-Games:I/InterphaseAmigaFormat/InterphaseAmigaFormat.slave
Into the Eagle's Nest	I/Into the Eagles Nest	A-Games:I/IntoTheEaglesNest/IntoTheEaglesNest.slave
International Sports Challenge	I/International Sports Chall	A-Games:I/IntSportsChallenge/IntSportsChallenge.slave
Invasion	I/Invasion	A-Games:I/Invasion/Invasion.Slave
Invest DE 1Disk	I/Invest DE 1Disk	A-Games:I/InvestDe1Disk/InvestDe1Disk.slave
Invest DE 2Disk	I/Invest DE 2Disk	A-Games:I/InvestDe2Disk/InvestDe2Disk.slave
Iron Lord	I/Iron Lord	A-Games:I/IronLord/IronLord.Slave
Iron Lord DE	I/Iron Lord DE	A-Games:I/IronLordDe/IronLordDe.Slave
Iron Lord FR	I/Iron Lord FR	A-Games:I/IronLordFr/IronLordFr.Slave
Iron Trackers	I/Iron Trackers	A-Games:I/IronTrackers/IronTrackers.Slave
Iron Trackers FR	I/Iron Trackers FR	A-Games:I/IronTrackersFr/IronTrackersFr.Slave
Ishar: Legend of the Fortress	I/Ishar Legend of the Fortre	A-Games:I/Ishar/Ishar.Slave
Ishar 2: Messengers of Doom	I/Ishar 2 Messengers of Doom	A-Games:I/Ishar2/Ishar2.Slave
Ishar 2: Messengers of Doom AGA	I/Ishar 2 Messengers of D V2	A-Games:I/Ishar2AGA/Ishar2AGA.Slave
Ishar 2: Messengers of Doom ES	I/Ishar 2 Messengers of D V3	A-Games:I/Ishar2Es/Ishar2Es.Slave
Ishar 3: The Seven Gates of Infinity	I/Ishar 3 The Seven Gates of	A-Games:I/Ishar3/Ishar3.Slave
Ishar 3: The Seven Gates of Infinity AGA	I/Ishar 3 The Seven Gates V2	A-Games:I/Ishar3AGA/Ishar3AGA.Slave
Ishar 3: The Seven Gates of Infinity DE	I/Ishar 3 The Seven Gates V3	A-Games:I/Ishar3De/Ishar3De.Slave
Ishar 3: The Seven Gates of Infinity FR	I/Ishar 3 The Seven Gates V4	A-Games:I/Ishar3Fr/Ishar3Fr.Slave
Ishar: Legend of the Fortress AGA	I/Ishar Legend of the For V2	A-Games:I/IsharAGA/IsharAGA.Slave
Ishar: Legend of the Fortress ES	I/Ishar Legend of the For V3	A-Games:I/IsharEs/IsharEs.Slave
Ishidó: The Way of Stones	I/Ishido The Way of Stones	A-Games:I/Ishido/Ishido.Slave
Island of Lost Hope, The	I/Island of Lost Hope. The	A-Games:I/IslandOfLostHope/IslandOfLostHope.Slave
ISS: Incredible Shrinking Sphere	I/ISS Incredible Shrinking S	A-Games:I/ISS/ISS.Slave
Italy 1990	I/Italy 1990	A-Games:I/Italia1990/Italia1990.slave
Italy 1990	I/Italy 1990 	A-Games:I/Italy1990/Italy1990.slave
Italy 1990: Winners Edition	I/Italy 1990 Winners Edition	A-Games:I/Italy1990WinnersEdition/Italy1990WinnersEdition.slave
It Came from the Desert	I/It Came from the Desert	A-Games:I/ItCameFromTheDesert/ItCameFromTheDesert.Slave
Ivanhoe	I/Ivanhoe	A-Games:I/Ivanhoe/Ivanhoe.slave
Incredible Adventures Of Moebius Goatlizard DX, The	I/Incredible Adventures Of M	A-Games:M/MoebiusGoatlizard/MoebiusGoatlizard.slave
Ivan 'Ironman' Stewart's Super Off Road	I/Ivan Ironman Stewarts Supe	A-Games:S/SuperOffRoad/SuperOffRoad.Slave
Ivan 'Ironman' Stewart's Super Off Road NTSC	I/Ivan Ironman Stewarts S V2	A-Games:S/SuperOffRoadNTSC/SuperOffRoadNTSC.Slave
Italy '90 Soccer	I/Italy 90 Soccer	A-Games:W/WorldClassSoccer/WorldClassSoccer.slave