Xmas Lemmings 1991	X/Xmas Lemmings 1991	A-Games:L/LemmingsXmasDemo1991/LemmingsXmasDemo1991.slave
Xmas Lemmings 1992	X/Xmas Lemmings 1992	A-Games:L/LemmingsXmasDemo1992/LemmingsXmasDemo1992.Slave
XTreme Racing CD AGA	X/XTreme Racing CD AGA	A-Games:U/UltimateXTremeRacingCD/UltimateXTremeRacingCD.slave
Xenex	X/Xenex	A-Games:X/Xenex/Xenex.Slave
Xenomorph	X/Xenomorph	A-Games:X/Xenomorph/Xenomorph.slave
Xenon	X/Xenon	A-Games:X/Xenon/Xenon.slave
Xenon 2: Megablast 1Disk	X/Xenon 2 Megablast 1Disk	A-Games:X/Xenon21Disk/Xenon21Disk.Slave
Xenon 2: Megablast 2Disk	X/Xenon 2 Megablast 2Disk	A-Games:X/Xenon22Disk/Xenon22Disk.Slave
Xenon 2: Megablast CDTV	X/Xenon 2 Megablast CDTV	A-Games:X/Xenon2CDTV/Xenon2CDTV.Slave
Xenon 2: Megablast Demo	X/Xenon 2 Megablast Demo	A-Games:X/Xenon2Demo/Xenon2Demo.Slave
Xenon 2: Megablast NTSC	X/Xenon 2 Megablast NTSC	A-Games:X/Xenon2NTSC/Xenon2NTSC.Slave
Xenon	X/Xenon 	A-Games:X/XenonArcadia/XenonArcadia.slave
Xenophobe	X/Xenophobe	A-Games:X/Xenophobe/Xenophobe.slave
Xiphos	X/Xiphos	A-Games:X/Xiphos/Xiphos.Slave
X-It IT	X/X-It IT	A-Games:X/XIt/XIt.Slave
X-Out 1Disk	X/X-Out 1Disk	A-Games:X/XOut1Disk/XOut1Disk.Slave
X-Out 2Disk	X/X-Out 2Disk	A-Games:X/XOut2Disk/XOut2Disk.Slave
XP8	X/XP8	A-Games:X/XP8/XP8.slave
XP8 AGA	X/XP8 AGA	A-Games:X/XP8AGA/XP8AGA.slave
XR-35 Fighter Mission	X/XR-35 Fighter Mission	A-Games:X/XR35/XR35.Slave
XTreme Racing DataDisk AGA	X/XTreme Racing DataDisk AGA	A-Games:X/XTremeRacing&DataDisksAGA/XTremeRacing&DataDisksAGA.slave
XTreme Racing AGA	X/XTreme Racing AGA	A-Games:X/XTremeRacingAGA/XTremeRacingAGA.slave
Xybots	X/Xybots	A-Games:X/Xybots/Xybots.Slave