Federation Quest 1: BSS Jane Seymour	F/Federation Quest 1 BSS Jan	A-Games:B/BSSJaneSeymour/BSSJaneSeymour.slave
F1	F/F1	A-Games:F/F1/F1.slave
F-15 Strike Eagle II	F/F-15 Strike Eagle II	A-Games:F/F15StrikeEagle2/F15StrikeEagle2.Slave
F-16 Combat Pilot	F/F-16 Combat Pilot	A-Games:F/F16CombatPilot/F16CombatPilot.slave
F17 Challenge	F/F17 Challenge	A-Games:F/F17Challenge/F17Challenge.Slave
F-19 Stealth Fighter	F/F-19 Stealth Fighter	A-Games:F/F19StealthFighter/F19StealthFighter.Slave
F1 Tornado	F/F1 Tornado	A-Games:F/F1Tornado/F1Tornado.Slave
F1 World Championship Edition	F/F1 World Championship Edit	A-Games:F/F1WorldChampionshipEd/F1WorldChampionshipEd.slave
F29 Retaliator	F/F29 Retaliator	A-Games:F/F29Retaliator/F29Retaliator.Slave
F40 Pursuit Simulator	F/F40 Pursuit Simulator	A-Games:F/F40PursuitSimulator/F40PursuitSimulator.Slave
F/A-18 Interceptor	F/FA-18 Interceptor	A-Games:F/FA18Interceptor/FA18Interceptor.slave
Face Off	F/Face Off	A-Games:F/FaceOff/FaceOff.Slave
Faery Tale Adventure, The	F/Faery Tale Adventure. The	A-Games:F/FaeryTaleAdventure/FaeryTaleAdventure.slave
Falcon	F/Falcon	A-Games:F/Falcon/Falcon.Slave
Falcon MissionDisk	F/Falcon MissionDisk	A-Games:F/Falcon&MissionDisks/Falcon&MissionDisks.Slave
Fallen Angel	F/Fallen Angel	A-Games:F/FallenAngel/FallenAngel.slave
Fantastic Dizzy	F/Fantastic Dizzy	A-Games:F/FantasticDizzy/FantasticDizzy.slave
Fantastic Voyage	F/Fantastic Voyage	A-Games:F/FantasticVoyage/FantasticVoyage.slave
Fantastic Voyage CDTV	F/Fantastic Voyage CDTV	A-Games:F/FantasticVoyageCDTV/FantasticVoyageCDTV.slave
Fantasy Flyer	F/Fantasy Flyer	A-Games:F/FantasyFlyer/FantasyFlyer.Slave
Fantasy Flyer AGA	F/Fantasy Flyer AGA	A-Games:F/FantasyFlyerAGA/FantasyFlyerAGA.Slave
Fantasy World Dizzy	F/Fantasy World Dizzy	A-Games:F/FantasyWorldDizzy/FantasyWorldDizzy.Slave
Fascination	F/Fascination	A-Games:F/Fascination/Fascination.Slave
Fascination DE	F/Fascination DE	A-Games:F/FascinationDe/FascinationDe.Slave
Fascination ES	F/Fascination ES	A-Games:F/FascinationEs/FascinationEs.Slave
Fascination FR	F/Fascination FR	A-Games:F/FascinationFr/FascinationFr.Slave
Fascination IT	F/Fascination IT	A-Games:F/FascinationIt/FascinationIt.Slave
Fast Brain PL	F/Fast Brain PL	A-Games:F/FastBrainPl/FastBrainPl.slave
Fast Break	F/Fast Break	A-Games:F/FastBreak/FastBreak.Slave
Fast Food!	F/Fast Food	A-Games:F/FastFood/FastFood.Slave
Fast Food!	F/Fast Food 	A-Games:F/FastFoodDizzyCollection/FastFoodDizzyCollection.Slave
Fast Lane! The Spice Engineering Challenge	F/Fast Lane The Spice Engine	A-Games:F/FastLane/FastLane.Slave
Fatal Heritage DE	F/Fatal Heritage DE	A-Games:F/FatalHeritageDe/FatalHeritageDe.Slave
Fatal Mission	F/Fatal Mission	A-Games:F/FatalMission/FatalMission.slave
Fate: Gates of Dawn	F/Fate Gates of Dawn	A-Games:F/FateGatesOfDawn/FateGatesOfDawn.Slave
Fate: Gates of Dawn DE	F/Fate Gates of Dawn DE	A-Games:F/FateGatesOfDawnDe/FateGatesOfDawnDe.Slave
Fatman: The Caped Consumer	F/Fatman The Caped Consumer	A-Games:F/FatmanCapedConsumer/FatmanCapedConsumer.Slave
Fatman: The Caped Consumer AGA	F/Fatman The Caped Consumer 	A-Games:F/FatmanCapedConsumerAGA/FatmanCapedConsumerAGA.Slave
Fears AGA	F/Fears AGA	A-Games:F/FearsAGA/FearsAGA.slave
Fears AGA Censored	F/Fears AGA Censored	A-Games:F/FearsAGACensored/FearsAGACensored.slave
Fears CD32	F/Fears CD32	A-Games:F/FearsCD32/FearsCD32.Slave
Federation of Free Traders	F/Federation of Free Traders	A-Games:F/FederationOfFreeTraders/FederationOfFreeTraders.slave
Femme Fatale	F/Femme Fatale	A-Games:F/FemmeFatale/FemmeFatale.Slave
Femme Fatale DataDisk	F/Femme Fatale DataDisk	A-Games:F/FemmeFatale&DataDisk/FemmeFatale&DataDisk.Slave
Fernandez Must Die	F/Fernandez Must Die	A-Games:F/FernandezMustDie/FernandezMustDie.Slave
Ferrari Formula One	F/Ferrari Formula One	A-Games:F/FerrariFormulaOne/FerrariFormulaOne.slave
Feud	F/Feud	A-Games:F/Feud/Feud.Slave
Fidelity Chessmaster 2100, The	F/Fidelity Chessmaster 2100.	A-Games:F/FidelityChessmaster2100/FidelityChessmaster2100.Slave
Fiendish Freddy's Big Top o' Fun	F/Fiendish Freddys Big Top o	A-Games:F/FiendishFreddysBigTopOFun/FiendishFreddysBigTopOFun.slave
FIFA International Soccer	F/FIFA International Soccer	A-Games:F/FIFAInternationalSoccer/FIFAInternationalSoccer.slave
Fighter Bomber	F/Fighter Bomber	A-Games:F/FighterBomber/FighterBomber.slave
Fighter Bomber	F/Fighter Bomber 	A-Games:F/FighterBomberAM/FighterBomberAM.slave
Fighter Duel Pro	F/Fighter Duel Pro	A-Games:F/FighterDuelPro/FighterDuelPro.Slave
Fighting Soccer NTSC	F/Fighting Soccer NTSC	A-Games:F/FightingSoccerNTSC/FightingSoccerNTSC.slave
Fightin' Spirit	F/Fightin Spirit	A-Games:F/FightinSpirit/FightinSpirit.slave
Fightin' Spirit AGA	F/Fightin Spirit AGA	A-Games:F/FightinSpiritAGA/FightinSpiritAGA.Slave
Fightin' Spirit CD32	F/Fightin Spirit CD32	A-Games:F/FightinSpiritCD32/FightinSpiritCD32.slave
Final Assault	F/Final Assault	A-Games:F/FinalAssault/FinalAssault.Slave
Final Battle, The	F/Final Battle. The	A-Games:F/FinalBattle/FinalBattle.slave
Final Battle, The DE	F/Final Battle. The DE	A-Games:F/FinalBattleDe/FinalBattleDe.slave
Final Blow	F/Final Blow	A-Games:F/FinalBlow/FinalBlow.slave
Final Countdown	F/Final Countdown	A-Games:F/FinalCountdown/FinalCountdown.Slave
Final Fight 1MB	F/Final Fight 1MB	A-Games:F/FinalFight1MB/FinalFight1MB.Slave
Final Fight 512K	F/Final Fight 512K	A-Games:F/FinalFight512k/FinalFight512k.slave
Fire & Forget	F/Fire Forget	A-Games:F/Fire&Forget/Fire&Forget.Slave
Fire & Forget II: The Death Convoy	F/Fire Forget II The Death C	A-Games:F/Fire&Forget2/Fire&Forget2.Slave
Fire and Ice	F/Fire and Ice	A-Games:F/Fire&Ice/Fire&Ice.slave
Fire! CD32	F/Fire CD32	A-Games:F/Fire&IceCD32/Fire&IceCD32.slave
Fire and Ice Demo	F/Fire and Ice Demo	A-Games:F/Fire&IceXmasDemo/Fire&IceXmasDemo.Slave
Fire and Brimstone	F/Fire and Brimstone	A-Games:F/FireAndBrimstone/FireAndBrimstone.Slave
Fireblaster	F/Fireblaster	A-Games:F/Fireblaster/Fireblaster.Slave
Fire Force	F/Fire Force	A-Games:F/FireForce/FireForce.slave
Fire Force CD32	F/Fire Force CD32	A-Games:F/FireForceCD32/FireForceCD32.slave
Firehawk	F/Firehawk	A-Games:F/Firehawk/FireHawk.Slave
Firepower	F/Firepower	A-Games:F/Firepower/Firepower.Slave
Firestar	F/Firestar	A-Games:F/Firestar/Firestar.Slave
First Contact	F/First Contact	A-Games:F/FirstContact/FirstContact.Slave
First Samurai, The	F/First Samurai. The	A-Games:F/FirstSamurai/FirstSamurai.Slave
Fish!	F/Fish	A-Games:F/Fish/Fish.Slave
Fist Fighter	F/Fist Fighter	A-Games:F/FistFighter/FistFighter.slave
Five-A-Side Soccer	F/Five-A-Side Soccer	A-Games:F/FiveASideSoccer/FiveASideSoccer.Slave
Flashback	F/Flashback	A-Games:F/Flashback/Flashback.Slave
Flashback CZ	F/Flashback CZ	A-Games:F/FlashbackCz/FlashbackCz.slave
Flashback DE	F/Flashback DE	A-Games:F/FlashbackDe/FlashbackDe.Slave
Flashback FR	F/Flashback FR	A-Games:F/FlashbackFr/FlashbackFr.Slave
Flashback IT	F/Flashback IT	A-Games:F/FlashbackIt/FlashbackIt.slave
Flashback LOWMEM	F/Flashback LOWMEM	A-Games:F/FlashbackLowMem/FlashbackLowMem.slave
Flashback CZ LOWMEM	F/Flashback CZ LOWMEM	A-Games:F/FlashbackLowMemCz/FlashbackLowMemCz.slave
Flashback DE LOWMEM	F/Flashback DE LOWMEM	A-Games:F/FlashbackLowMemDe/FlashbackLowMemDe.slave
Flashback FR LOWMEM	F/Flashback FR LOWMEM	A-Games:F/FlashbackLowMemFr/FlashbackLowMemFr.slave
Flashback IT LOWMEM	F/Flashback IT LOWMEM	A-Games:F/FlashbackLowMemIt/FlashbackLowMemIt.slave
Flashback PL LOWMEM	F/Flashback PL LOWMEM	A-Games:F/FlashbackLowMemPl/FlashbackLowMemPl.slave
Flashback PL	F/Flashback PL	A-Games:F/FlashbackPl/FlashbackPl.slave
Flies: Attack on Earth DE	F/Flies Attack on Earth DE	A-Games:F/FliesAttackOnEarthDe/FliesAttackOnEarthDe.Slave
Flight of the Amazon Queen	F/Flight of the Amazon Queen	A-Games:F/FlightOfTheAmazonQueen/FlightOfTheAmazonQueen.Slave
Flight of the Intruder	F/Flight of the Intruder	A-Games:F/FlightOfTheIntruder/FlightOfTheIntruder.Slave
Flight Path 737	F/Flight Path 737	A-Games:F/FlightPath737/FlightPath737.Slave
Flight Simulator II SceneryDisk07	F/Flight Simulator II Scener	A-Games:F/FlightSim2&SceneryDisk07/FlightSim2&SceneryDisk07.Slave
Flight Simulator II SceneryDisk09	F/Flight Simulator II Sce V2	A-Games:F/FlightSim2&SceneryDisk09/FlightSim2&SceneryDisk09.Slave
Flight Simulator II SceneryDisk11	F/Flight Simulator II Sce V3	A-Games:F/FlightSim2&SceneryDisk11/FlightSim2&SceneryDisk11.Slave
Flight Simulator II SceneryDisk12	F/Flight Simulator II Sce V4	A-Games:F/FlightSim2&SceneryDisk12/FlightSim2&SceneryDisk12.Slave
Flight Simulator II SceneryDisk13	F/Flight Simulator II Sce V5	A-Games:F/FlightSim2&SceneryDisk13/FlightSim2&SceneryDisk13.Slave
Flight Simulator II SceneryDisk14	F/Flight Simulator II Sce V6	A-Games:F/FlightSim2&SceneryDisk14/FlightSim2&SceneryDisk14.Slave
Flight Simulator II	F/Flight Simulator II	A-Games:F/FlightSimulator2/FlightSimulator2.Slave
Flight Simulator II FlightSim2 Hawaiian	F/Flight Simulator II Flight	A-Games:F/FlightSimulator2&Hawaiian/FlightSim2&Hawaiian.Slave
Flimbo's Quest	F/Flimbos Quest	A-Games:F/FlimbosQuest/FlimbosQuest.slave
Flintstones, The	F/Flintstones. The	A-Games:F/Flintstones/Flintstones.Slave
Flip Flop	F/Flip Flop	A-Games:F/FlipFlop/FlipFlop.Slave
Flip-it & Magnose: Water Carriers from Mars	F/Flip-it Magnose Water Carr	A-Games:F/Flipit&Magnose/Flipit&Magnose.slave
Flood	F/Flood	A-Games:F/Flood/Flood.Slave
Floor 13	F/Floor 13	A-Games:F/Floor13/Floor13.Slave
Flight of the Amazon Queen DE	F/Flight of the Amazon Qu V2	A-Games:F/FlugDerAmazonQueenDe/FlugDerAmazonQueenDe.Slave
Fly Fighter	F/Fly Fighter	A-Games:F/FlyFighter/FlyFighter.Slave
Fly Fighter highs	F/Fly Fighter highs	A-Games:F/FlyFighter/highs
Fly Harder	F/Fly Harder	A-Games:F/FlyHarder/FlyHarder.slave
Fly Harder CD32	F/Fly Harder CD32	A-Games:F/FlyHarderCD32/FlyHarderCD32.slave
Flying Shark	F/Flying Shark	A-Games:F/FlyingShark/FlyingShark.Slave
Fool's Errand, The	F/Fools Errand. The	A-Games:F/FoolsErrand/FoolsErrand.Slave
Footballer of the Year 2	F/Footballer of the Year 2	A-Games:F/FootballerOfTheYear2/FootballerOfTheYear2.slave
Football Glory	F/Football Glory	A-Games:F/FootballGlory/FootballGlory.Slave
Football Glory AGA	F/Football Glory AGA	A-Games:F/FootballGloryAGA/FootballGloryAGA.Slave
Football Manager 2	F/Football Manager 2	A-Games:F/FootballManager2/FootballManager2.slave
Football Manager: World Cup Edition	F/Football Manager World Cup	A-Games:F/FootballManagerWCEd/FootballManagerWCEd.Slave
Football Manager: World Cup Edition DE	F/Football Manager World  V2	A-Games:F/FootballManagerWCEdDe/FootballManagerWCEdDe.Slave
Forgotten Mine	F/Forgotten Mine	A-Games:F/ForgottenMine/ForgottenMine.slave
Forgotten Worlds	F/Forgotten Worlds	A-Games:F/ForgottenWorlds/ForgottenWorlds.Slave
Formula 1 Grand Prix	F/Formula 1 Grand Prix	A-Games:F/Formula1GrandPrix/Formula1GrandPrix.Slave
Formula 1 3D	F/Formula 1 3D	A-Games:F/FormulaOne3D/FormulaOne3D.slave
Formula One Grand Prix 3Disk	F/Formula One Grand Prix 3Di	A-Games:F/FormulaOneGrandPrix3Disk/FormulaOneGrandPrix3Disk.Slave
Formula One Grand Prix 4Disk	F/Formula One Grand Prix 4Di	A-Games:F/FormulaOneGrandPrix4Disk/FormulaOneGrandPrix4Disk.Slave
Foundation's Waste	F/Foundations Waste	A-Games:F/FoundationsWaste/FoundationsWaste.Slave
Franco Baresi World Cup Kick Off IT	F/Franco Baresi World Cup Ki	A-Games:F/FrancoBaresiWorldCupIt/FrancoBaresiWorldCupIt.Slave
Frankenstein	F/Frankenstein	A-Games:F/Frankenstein/Frankenstein.slave
Franko: The Crazy Revenge! PL Censored	F/Franko The Crazy Revenge P	A-Games:F/FrankoCensoredPl/FrankoCensoredPl.slave
Franko: The Crazy Revenge! PL	F/Franko The Crazy Reveng V2	A-Games:F/FrankoPl/FrankoPl.Slave
Frantic Freddie	F/Frantic Freddie	A-Games:F/FranticFreddie/FranticFreddie.Slave
Freak Out	F/Freak Out	A-Games:F/FreakOut/FreakOut.slave
Freedom: Rebels in the Darkness	F/Freedom Rebels in the Dark	A-Games:F/Freedom/Freedom.Slave
Freedom: Rebels in the Darkness DE	F/Freedom Rebels in the D V2	A-Games:F/FreedomDe/FreedomDe.Slave
Freedom: Rebels in the Darkness ES	F/Freedom Rebels in the D V3	A-Games:F/FreedomEs/FreedomEs.Slave
Freedom: Rebels in the Darkness FR	F/Freedom Rebels in the D V4	A-Games:F/FreedomFr/FreedomFr.Slave
Frenetic	F/Frenetic	A-Games:F/Frenetic/Frenetic.Slave
Fright Night	F/Fright Night	A-Games:F/FrightNight/FrightNight.Slave
Frontier: Elite II	F/Frontier Elite II	A-Games:F/Frontier/Frontier.slave
Frontier: Elite II CD32	F/Frontier Elite II CD32	A-Games:F/FrontierCD32/FrontierCD32.slave
Frontier: Elite II CZ	F/Frontier Elite II CZ	A-Games:F/FrontierCz/FrontierCz.slave
Frontier: Elite II DE	F/Frontier Elite II DE	A-Games:F/FrontierDe/FrontierDe.slave
Frontier: Elite II FR	F/Frontier Elite II FR	A-Games:F/FrontierFr/FrontierFr.slave
Frost Byte	F/Frost Byte	A-Games:F/FrostByte/FrostByte.Slave
Full Contact	F/Full Contact	A-Games:F/FullContact/FullContact.slave
Full Metal Planete Files	F/Full Metal Planete Files	A-Games:F/FullMetalPlaneteFiles/FullMetalPlaneteFiles.Slave
Full Metal Planete Image	F/Full Metal Planete Image	A-Games:F/FullMetalPlaneteImage/FullMetalPlaneteImage.Slave
Full Metal Planete Files NTSC	F/Full Metal Planete Files N	A-Games:F/FullMetalPlaneteNTSCFiles/FullMetalPlaneteNTSCFiles.Slave
Full Metal Planete Image NTSC	F/Full Metal Planete Image N	A-Games:F/FullMetalPlaneteNTSCImage/FullMetalPlaneteNTSCImage.Slave
Funturatum PL	F/Funturatum PL	A-Games:F/FunturatumPl/FunturatumPl.slave
Fury of the Furries	F/Fury of the Furries	A-Games:F/FuryOfTheFurries/FuryOfTheFurries.Slave
Fury of the Furries CD32	F/Fury of the Furries CD32	A-Games:F/FuryOfTheFurriesCD32/FuryOfTheFurriesCD32.Slave
Fusion	F/Fusion	A-Games:F/Fusion/Fusion.Slave
Fuﬂball Total! DE	F/Fuball Total DE	A-Games:F/FussballTotalDe/FussballTotalDe.Slave
Future Basketball	F/Future Basketball	A-Games:F/FutureBasketball/FutureBasketball.Slave
Future Bike Simulator	F/Future Bike Simulator	A-Games:F/FutureBikeSimulator/FutureBikeSimulator.Slave
Future Classics Collection	F/Future Classics Collection	A-Games:F/FutureClassicsCollection/FutureClassicsCollection.Slave
Future Shock	F/Future Shock	A-Games:F/FutureShock/FutureShock.slave
Future Tank	F/Future Tank	A-Games:F/FutureTank/FutureTank.slave
Future Wars: Time Travellers	F/Future Wars Time Traveller	A-Games:F/FutureWars/FutureWars.slave
Future Wars: Time Travellers DE	F/Future Wars Time Travel V2	A-Games:F/FutureWarsDe/FutureWarsDe.slave
Future Wars: Time Travellers ES	F/Future Wars Time Travel V3	A-Games:F/FutureWarsEs/FutureWarsEs.slave
Future Wars: Time Travellers IT	F/Future Wars Time Travel V4	A-Games:F/FutureWarsIt/FutureWarsIt.slave
Fuzzball	F/Fuzzball	A-Games:F/Fuzzball/Fuzzball.Slave
Fuzzball Intro	F/Fuzzball Intro	A-Games:F/Fuzzball/Intro.Slave
Fuzzball NoIntro	F/Fuzzball NoIntro	A-Games:F/FuzzballNoIntro/FuzzballNoIntro.Slave
F1-Racer	F/F1-Racer	A-Games:K/Kinderama/Kinderama.Slave
Flight of the Amazon Queen FR	F/Flight of the Amazon Qu V3	A-Games:L/LAmazoneQueenFr/LAmazoneQueenFr.Slave
Fetiche Maya, Le	F/Fetiche Maya. Le	A-Games:M/Maya/Maya.Slave
Fetiche Maya, Le ES	F/Fetiche Maya. Le ES	A-Games:M/MayaEs/MayaEs.Slave
Fetiche Maya, Le FAST	F/Fetiche Maya. Le FAST	A-Games:M/MayaFast/MayaFast.slave
Fetiche Maya, Le ES FAST	F/Fetiche Maya. Le ES FAST	A-Games:M/MayaFastEs/MayaFastEs.Slave
Fetiche Maya, Le FR FAST	F/Fetiche Maya. Le FR FAST	A-Games:M/MayaFastFr/MayaFastFr.slave
Fetiche Maya, Le FR	F/Fetiche Maya. Le FR	A-Games:M/MayaFr/MayaFr.Slave
F-117A Nighthawk Stealth Fighter 2.0	F/F-117A Nighthawk Stealth F	A-Games:N/NightHawkF117A/NightHawkF117A.slave