Je Découvre Les Couleurs FR	J/Je Decouvre Les Couleurs F	A-Games:D/DenverJeFaisDesCouleursFr/DenverJeFaisDesCouleursFr.Slave
Jabato vs. Imperio: Libertad ES	J/Jabato vs. Imperio Liberta	A-Games:J/JabatoEs/JabatoEs.slave
Jaguar XJ220 Files	J/Jaguar XJ220 Files	A-Games:J/JaguarXJ220Files/JaguarXJ220Files.slave
Jaguar XJ220 Image	J/Jaguar XJ220 Image	A-Games:J/JaguarXJ220Image/JaguarXJ220Image.slave
Jahangir Khan's World Championship Squash	J/Jahangir Khans World Champ	A-Games:J/JahangirKhansWChampSquash/JahangirKhansWChampSquash.Slave
James Bond: The Stealth Affair	J/James Bond The Stealth Aff	A-Games:J/JamesBondTheStealthAffair/JamesBondTheStealthAffair.Slave
James Pond: Underwater Agent	J/James Pond Underwater Agen	A-Games:J/JamesPond/JamesPond.slave
James Pond 2: Codename RoboCod	J/James Pond 2 Codename Robo	A-Games:J/JamesPond2/JamesPond2.Slave
James Pond 2: Codename RoboCod	J/James Pond 2 Codename R V2	A-Games:J/JamesPond2CD32/data/JamesPond2.Slave
James Pond 2: Codename RoboCod AGA	J/James Pond 2 Codename R V3	A-Games:J/JamesPond2AGA/JamesPond2AGA.Slave
James Pond 2: Codename RoboCod CD32	J/James Pond 2 Codename R V4	A-Games:J/JamesPond2CD32/JamesPond2CD32.Slave
James Pond 3: Operation Starfish AGA	J/James Pond 3 Operation Sta	A-Games:J/JamesPond3AGA/JamesPond3AGA.slave
James Pond 3: Operation Starfish CD32	J/James Pond 3 Operation  V2	A-Games:J/JamesPond3CD32/JamesPond3CD32.slave
Jaws	J/Jaws	A-Games:J/Jaws/Jaws.Slave
Jet	J/Jet	A-Games:J/Jet/Jet.Slave
Jet Hawaiian	J/Jet Hawaiian	A-Games:J/Jet&HawaiianScenery/Jet&HawaiianScenery.Slave
Jet SceneryDisk07	J/Jet SceneryDisk07	A-Games:J/Jet&SceneryDisk07/Jet&SceneryDisk07.Slave
Jet SceneryDisk09	J/Jet SceneryDisk09	A-Games:J/Jet&SceneryDisk09/Jet&SceneryDisk09.Slave
Jet SceneryDisk11	J/Jet SceneryDisk11	A-Games:J/Jet&SceneryDisk11/Jet&SceneryDisk11.Slave
Jet SceneryDisk12	J/Jet SceneryDisk12	A-Games:J/Jet&SceneryDisk12/Jet&SceneryDisk12.Slave
Jet SceneryDisk13	J/Jet SceneryDisk13	A-Games:J/Jet&SceneryDisk13/Jet&SceneryDisk13.Slave
Jet SceneryDisk14	J/Jet SceneryDisk14	A-Games:J/Jet&SceneryDisk14/Jet&SceneryDisk14.Slave
Jet Set Willy II	J/Jet Set Willy II	A-Games:J/JetSetWilly2/JetSetWilly2.slave
Jetsons: The Computer Game	J/Jetsons The Computer Game	A-Games:J/JetsonsTheComputerGame/JetsonsTheComputerGame.Slave
Jetstrike	J/Jetstrike	A-Games:J/Jetstrike/Jetstrike.Slave
Jetstrike Intro	J/Jetstrike Intro	A-Games:J/Jetstrike/JetstrikeIntro.Slave
Jetstrike AGA	J/Jetstrike AGA	A-Games:J/JetstrikeAGA/JetstrikeAGA.Slave
Jetstrike Intro AGA	J/Jetstrike Intro AGA	A-Games:J/JetstrikeAGA/JetstrikeAGAIntro.Slave
Jewels of Darkness	J/Jewels of Darkness	A-Games:J/JewelsOfDarkness/JewelsOfDarkness.Slave
Jimmy's Fantastic Journey	J/Jimmys Fantastic Journey	A-Games:J/JimmysFantasticJourney/JimmysFantasticJourney.slave
Jimmy White's Whirlwind Snooker	J/Jimmy Whites Whirlwind Sno	A-Games:J/JimmyWhitesSnooker/JimmyWhitesSnooker.slave
Jimmy Willburne - A La Recherche Du Peigne Perdu Intro FR	J/Jimmy Willburne - A La Rec	A-Games:J/JimmyWillburneFr/IntroFr.Slave
Jimmy Willburne - A La Recherche Du Peigne Perdu FR	J/Jimmy Willburne - A La  V2	A-Games:J/JimmyWillburneFr/JimmyWillburneFr.Slave
Jim Power in Mutant Planet	J/Jim Power in Mutant Planet	A-Games:J/JimPower/JimPower.Slave
Jinks	J/Jinks	A-Games:J/Jinks/Jinks.Slave
Jinxter	J/Jinxter	A-Games:J/Jinxter/Jinxter.Slave
Jocky Wilson's Darts Challenge	J/Jocky Wilsons Darts Challe	A-Games:J/JockyWilsonsDartChallenge/JockyWilsonsDartChallenge.slave
Joe & Mac: Caveman Ninja	J/Joe Mac Caveman Ninja	A-Games:J/Joe&MacCavemanNinja/Joe&MacCavemanNinja.Slave
Joe Blade	J/Joe Blade	A-Games:J/JoeBlade/JoeBlade.Slave
Joe Blade 2	J/Joe Blade 2	A-Games:J/JoeBlade2/JoeBlade2.Slave
John Barnes European Football	J/John Barnes European Footb	A-Games:J/JohnBarnesEuroFootball/JohnBarnesEuroFootball.Slave
John Lowe's Ultimate Darts	J/John Lowes Ultimate Darts	A-Games:J/JohnLowesUltimateDarts/JohnLowesUltimateDarts.Slave
John Madden Football	J/John Madden Football	A-Games:J/JohnMaddenFootball/JohnMaddenFootball.slave
Jonathan DE	J/Jonathan DE	A-Games:J/JonathanDe/JonathanDe.Slave
Journey	J/Journey	A-Games:J/Journey/Journey.Slave
Jouster 3	J/Jouster 3	A-Games:J/Jouster3/Jouster3.slave
Judge Dredd	J/Judge Dredd	A-Games:J/JudgeDredd/JudgeDredd.slave
Jug	J/Jug	A-Games:J/Jug/Jug.Slave
Jumping Jack'son	J/Jumping Jackson	A-Games:J/JumpingJackSon/JumpingJackSon.slave
Jump'n Roll	J/Jumpn Roll	A-Games:J/JumpNRoll/JumpNRoll.Slave
Jungle Strike 1MB	J/Jungle Strike 1MB	A-Games:J/JungleStrike1MB/JungleStrike1MB.Slave
Jungle Strike 2MB	J/Jungle Strike 2MB	A-Games:J/JungleStrike2MB/JungleStrike2MB.Slave
Jungle Strike CD32	J/Jungle Strike CD32	A-Games:J/JungleStrikeCD32/JungleStrikeCD32.Slave
Junior Typist	J/Junior Typist	A-Games:J/JuniorTypist/JuniorTypist.Slave
Jupiter Probe	J/Jupiter Probe	A-Games:J/JupiterProbe/JupiterProbe.Slave
Jupiter's Masterdrive	J/Jupiters Masterdrive	A-Games:J/JupitersMasterdrive/JupitersMasterdrive.Slave
Jurassic Park	J/Jurassic Park	A-Games:J/JurassicPark/JurassicPark.slave
Jurassic Park AGA	J/Jurassic Park AGA	A-Games:J/JurassicParkAGA/JurassicParkAGA.slave