Simpsons, The: Bart vs. the Space Mutants 1Disk	S/Simpsons. The Bart vs. the	A-Games:B/BartVsSpaceMutants1Disk/BartVsSpaceMutants1Disk.Slave
Simpsons, The: Bart vs. the Space Mutants 2Disk	S/Simpsons. The Bart vs.  V2	A-Games:B/BartVsSpaceMutants2Disk/BartVsSpaceMutants2Disk.Slave
Simpsons, The: Bart vs. the Space Mutants Intro 2Disk	S/Simpsons. The Bart vs.  V3	A-Games:B/BartVsSpaceMutants2Disk/Intro2Disk.slave
Simpsons, The: Bart vs. the World	S/Simpsons. The Bart vs.  V4	A-Games:B/BartVsTheWorld/BartVsTheWorld.slave
Star Wars: The Empire Strikes Back	S/Star Wars The Empire Strik	A-Games:E/EmpireStrikesBack/EmpireStrikesBack.Slave
Star Wars: Return of the Jedi	S/Star Wars Return of the Je	A-Games:R/ReturnOfTheJedi/ReturnOfTheJedi.slave
Sabre Team	S/Sabre Team	A-Games:S/SabreTeam/SabreTeam.Slave
Sabre Team AGA	S/Sabre Team AGA	A-Games:S/SabreTeamAGA/SabreTeamAGA.Slave
Sabre Team CD32	S/Sabre Team CD32	A-Games:S/SabreTeamCD32/SabreTeamCD32.Slave
Safari Guns	S/Safari Guns	A-Games:S/SafariGuns/SafariGuns.Slave
Safari Guns FR	S/Safari Guns FR	A-Games:S/SafariGunsFr/SafariGunsFr.Slave
Saint & Greavsie	S/Saint Greavsie	A-Games:S/Saint&Greavsie/Saint&Greavsie.Slave
Saint Dragon	S/Saint Dragon	A-Games:S/SaintDragon/SaintDragon.Slave
Salmon-Pink Max	S/Salmon-Pink Max	A-Games:S/SalmonPinkMax/SalmonPinkMax.Slave
Sanctuary DE	S/Sanctuary DE	A-Games:S/SanctuaryDe/SanctuaryDe.Slave
Santa's Xmas Caper	S/Santas Xmas Caper	A-Games:S/SantasXmasCaper/SantasXmasCaper.Slave
Sarakon	S/Sarakon	A-Games:S/Sarakon/Sarakon.slave
Sarcophaser	S/Sarcophaser	A-Games:S/Sarcophaser/Sarcophaser.Slave
SAS Combat Simulator	S/SAS Combat Simulator	A-Games:S/SASCombatSimulatorQArcade/SASCombatSimulatorQArcade.Slave
SAS Combat Simulator	S/SAS Combat Simulator 	A-Games:S/SASCombatSimulatorQFight/SASCombatSimulatorQFight.Slave
Satan	S/Satan	A-Games:S/Satan/Satan.Slave
Savage	S/Savage	A-Games:S/Savage/Savage.Slave
Scapeghost	S/Scapeghost	A-Games:S/Scapeghost/Scapeghost.Slave
Schwarze Auge, Das: Die Schicksalsklinge DE	S/Schwarze Auge. Das Die Sch	A-Games:S/SchwarzeAugeDe/SchwarzeAugeDe.slave
Scooby Doo and Scrappy Doo	S/Scooby Doo and Scrappy Doo	A-Games:S/ScoobyDoo&ScrappyDoo/ScoobyDoo&ScrappyDoo.slave
Scorpio	S/Scorpio	A-Games:S/Scorpio/Scorpio.Slave
Scorpion	S/Scorpion	A-Games:S/Scorpion/Scorpion.Slave
Scorpion highs	S/Scorpion highs	A-Games:S/Scorpion/highs
Scrabble	S/Scrabble	A-Games:S/Scrabble/Scrabble.Slave
Scramble Spirits	S/Scramble Spirits	A-Games:S/ScrambleSpirits/ScrambleSpirits.Slave
Scrolling Walls	S/Scrolling Walls	A-Games:S/ScrollingWalls/ScrollingWalls.Slave
S.D.I.	S/S.D.I.	A-Games:S/SDICinemaware/SDICinemaware.Slave
Second Samurai	S/Second Samurai	A-Games:S/SecondSamurai/SecondSamurai.slave
Second Samurai AGA	S/Second Samurai AGA	A-Games:S/SecondSamuraiAGA/SecondSamuraiAGA.slave
Seconds Out..!	S/Seconds Out..	A-Games:S/SecondsOut/SecondsOut.Slave
Secret of Monkey Island, The	S/Secret of Monkey Island. T	A-Games:S/SecretOfMonkeyIsland/SecretOfMonkeyIsland.slave
Secret of Monkey Island, The DE	S/Secret of Monkey Island V2	A-Games:S/SecretOfMonkeyIslandDe/SecretOfMonkeyIslandDe.slave
Secret of Monkey Island, The ES	S/Secret of Monkey Island V3	A-Games:S/SecretOfMonkeyIslandEs/SecretOfMonkeyIslandEs.slave
Secret of Monkey Island, The FR	S/Secret of Monkey Island V4	A-Games:S/SecretOfMonkeyIslandFr/SecretOfMonkeyIslandFr.slave
Secret of Monkey Island, The IT	S/Secret of Monkey Island V5	A-Games:S/SecretOfMonkeyIslandIt/SecretOfMonkeyIslandIt.slave
Secret of the Silver Blades	S/Secret of the Silver Blade	A-Games:S/SecretOfTheSilverBlades/SecretOfTheSilverBlades.Slave
Seek and Destroy	S/Seek and Destroy	A-Games:S/Seek&Destroy/Seek&Destroy.Slave
Seek and Destroy AGA	S/Seek and Destroy AGA	A-Games:S/Seek&DestroyAGA/Seek&DestroyAGA.Slave
Sensible Golf	S/Sensible Golf	A-Games:S/SensibleGolf/SensibleGolf.Slave
Sensible Soccer 1MB	S/Sensible Soccer 1MB	A-Games:S/SensibleSoccer1MB/SensibleSoccer1MB.Slave
Sensible Soccer 512KB	S/Sensible Soccer 512KB	A-Games:S/SensibleSoccer512KB/SensibleSoccer512KB.Slave
Sensible Soccer 1MB	S/Sensible Soccer 1MB 	A-Games:S/SensibleSoccer92931MB/SensibleSoccer92931MB.Slave
Sensible Soccer: European Champions v1.1 (92/93 Edition) 512KB	S/Sensible Soccer European C	A-Games:S/SensibleSoccer9293512KB/SensibleSoccer9293512KB.Slave
Sensible Soccer: England vs Germany	S/Sensible Soccer England vs	A-Games:S/SensibleSoccerBulldogBlty/SensibleSoccerBulldogBlty.Slave
Sensible Soccer 1MB	S/Sensible Soccer 1MB  	A-Games:S/SensibleSoccerEuro1MB/SensibleSoccerEuro1MB.Slave
Sensible Soccer v1.1 - European Champions 512KB	S/Sensible Soccer v1.1 - Eur	A-Games:S/SensibleSoccerEuro512KB/SensibleSoccerEuro512KB.Slave
Sensible Soccer 1MB	S/Sensible Soccer 1MB   	A-Games:S/SensibleSoccerIntEd1MB/SensibleSoccerIntEd1MB.Slave
Sensible Soccer v1.2 - International Edition 512KB	S/Sensible Soccer v1.2 - Int	A-Games:S/SensibleSoccerIntEd512KB/SensibleSoccerIntEd512KB.Slave
Sensible Soccer v1.2 - International Edition CD32	S/Sensible Soccer v1.2 -  V2	A-Games:S/SensibleSoccerIntlEdCD32/SensibleSoccerIntlEdCD32.Slave
Sensible Train-spotting	S/Sensible Train-spotting	A-Games:S/SensibleTrainSpotting/SensibleTrainSpotting.Slave
Sensible World Of Moon Soccer	S/Sensible World Of Moon Soc	A-Games:S/SensibleWorldMoonSoccer/SensibleWorldMoonSoccer.Slave
Sensible World of Soccer	S/Sensible World of Soccer	A-Games:S/SensibleWorldOfSoccer/SensibleWorldOfSoccer.Slave
Sensible World of Soccer	S/Sensible World of Soccer 	A-Games:S/SensibleWorldOfSoccer11/SensibleWorldOfSoccer11.Slave
Sensible World of Soccer	S/Sensible World of Soccer  	A-Games:S/SensibleWorldOfSoccer1617/SensibleWorldOfSoccer1617.Slave
Sensible World of Soccer '95/'96	S/Sensible World of Soccer 9	A-Games:S/SensibleWorldOfSoccer9596/SensibleWorldOfSoccer9596.Slave
Sensible World of Soccer '96/'97	S/Sensible World of Socce V2	A-Games:S/SensibleWorldOfSoccer9697/SensibleWorldOfSoccer9697.Slave
Sensible World of Soccer	S/Sensible World of Socce V3	A-Games:S/SensibleWorldOfSoccer9798/SensibleWorldOfSoccer9798.Slave
Sensible World of Soccer	S/Sensible World of Socce V4	A-Games:S/SensibleWorldOfSoccerEuro/SensibleWorldOfSoccerEuro.Slave
Sensible World of Soccer	S/Sensible World of Socce V5	A-Games:S/SensibleWorldOfSoccerWC98/SensibleWorldOfSoccerWC98.Slave
Sentinel, The	S/Sentinel. The	A-Games:S/Sentinel/Sentinel.Slave
Settlers, The	S/Settlers. The	A-Games:S/Settlers/Settlers.slave
Settlers, The FR	S/Settlers. The FR	A-Games:S/SettlersFr/SettlersFr.slave
Seven Cities of Gold	S/Seven Cities of Gold	A-Games:S/SevenCitiesOfGold/SevenCitiesOfGold.slave
Seven Gates of Jambala, The Files	S/Seven Gates of Jambala. Th	A-Games:S/SevenGatesOfJambalaFiles/SevenGatesOfJambalaFiles.slave
Seven Gates of Jambala, The Image	S/Seven Gates of Jambala. V2	A-Games:S/SevenGatesOfJambalaImage/SevenGatesOfJambalaImage.slave
Sextimates	S/Sextimates	A-Games:S/Sextimates/Sextimates.Slave
Seymour goes to Hollywood	S/Seymour goes to Hollywood	A-Games:S/SeymourGoesToHollywood/SeymourGoesToHollywood.slave
Shadow Dancer	S/Shadow Dancer	A-Games:S/ShadowDancer/ShadowDancer.slave
Shadow Fighter	S/Shadow Fighter	A-Games:S/ShadowFighter/ShadowFighter.Slave
Shadow Fighter AGA	S/Shadow Fighter AGA	A-Games:S/ShadowFighterAGA/ShadowFighterAGA.Slave
Shadow Fighter CD32	S/Shadow Fighter CD32	A-Games:S/ShadowFighterCD32/ShadowFighterCD32.Slave
Shadowgate	S/Shadowgate	A-Games:S/Shadowgate/Shadowgate.Slave
Shadowlands	S/Shadowlands	A-Games:S/Shadowlands/Shadowlands.Slave
Shadow of the Beast	S/Shadow of the Beast	A-Games:S/ShadowOfTheBeast/ShadowOfTheBeast.slave
Shadow of the Beast II	S/Shadow of the Beast II	A-Games:S/ShadowOfTheBeast2/ShadowOfTheBeast2.Slave
Shadow of the Beast II Demo	S/Shadow of the Beast II Dem	A-Games:S/ShadowOfTheBeast2Demo/ShadowOfTheBeast2Demo.Slave
Shadow of the Beast II NTSC	S/Shadow of the Beast II NTS	A-Games:S/ShadowOfTheBeast2NTSC/ShadowOfTheBeast2NTSC.Slave
Shadow of the Beast III	S/Shadow of the Beast III	A-Games:S/ShadowOfTheBeast3/ShadowOfTheBeast3.slave
Shadow of the Beast III NTSC	S/Shadow of the Beast III NT	A-Games:S/ShadowOfTheBeast3NTSC/ShadowOfTheBeast3NTSC.slave
Shadow of the Beast Demo	S/Shadow of the Beast Demo	A-Games:S/ShadowOfTheBeastDemo/ShadowOfTheBeastDemo.Slave
Shadoworlds	S/Shadoworlds	A-Games:S/Shadoworlds/Shadoworlds.Slave
Shadow Sorcerer IT FR DE	S/Shadow Sorcerer IT FR DE	A-Games:S/ShadowSorcererDeFrIt/ShadowSorcererDeFrIt.Slave
Shadow Warriors	S/Shadow Warriors	A-Games:S/ShadowWarriors/ShadowWarriors.Slave
Shadow Warriors	S/Shadow Warriors 	A-Games:S/ShadowWarriors/ShadowWarriors.slave
Shanghai	S/Shanghai	A-Games:S/Shanghai/Shanghai.Slave
Shanghai FR	S/Shanghai FR	A-Games:S/ShanghaiFr/ShanghaiFr.Slave
Shaq Fu	S/Shaq Fu	A-Games:S/ShaqFu/ShaqFu.slave
Shaq Fu AGA	S/Shaq Fu AGA	A-Games:S/ShaqFuAGA/ShaqFuAGA.slave
Sharkey's Moll	S/Sharkeys Moll	A-Games:S/SharkeysMoll/SharkeysMoll.Slave
She-Fox	S/She-Fox	A-Games:S/SheFox/SheFox.slave
Sherman M4	S/Sherman M4	A-Games:S/ShermanM4/ShermanM4.slave
Shinobi	S/Shinobi	A-Games:S/Shinobi/Shinobi.Slave
Shinobi NTSC	S/Shinobi NTSC	A-Games:S/ShinobiNTSC/ShinobiNTSC.Slave
ShockWave	S/ShockWave	A-Games:S/ShockWave/ShockWave.Slave
Short Grey, The Intro FR	S/Short Grey. The Intro FR	A-Games:S/ShortgreyFr/IntroFr.Slave
Short Grey, The FR	S/Short Grey. The FR	A-Games:S/ShortgreyFr/ShortgreyFr.Slave
Shuffle	S/Shuffle	A-Games:S/Shuffle/Shuffle.Slave
Shufflepuck Café	S/Shufflepuck Cafe	A-Games:S/ShufflepuckCafe/ShufflepuckCafe.Slave
Shufflepuck Café FR	S/Shufflepuck Cafe FR	A-Games:S/ShufflepuckCafeFr/ShufflepuckCafeFr.Slave
Shuttle: The Space Flight Simulator	S/Shuttle The Space Flight S	A-Games:S/Shuttle/Shuttle.Slave
SideArms	S/SideArms	A-Games:S/SideArms/SideArms.slave
Sideshow	S/Sideshow	A-Games:S/SideShow/SideShow.Slave
SideWinder	S/SideWinder	A-Games:S/SideWinder/Sidewinder.Slave
SideWinder II	S/SideWinder II	A-Games:S/SideWinder2/SideWinder2.Slave
SideWinder	S/SideWinder 	A-Games:S/SideWinderArcadia/SideWinderArcadia.Slave
Siedler, Die DE	S/Siedler. Die DE	A-Games:S/SiedlerDe/SiedlerDe.slave
Sierra Soccer: World Challenge Edition	S/Sierra Soccer World Challe	A-Games:S/SierraSoccer/SierraSoccer.Slave
Silent Service	S/Silent Service	A-Games:S/SilentService/SilentService.Slave
Silent Service II	S/Silent Service II	A-Games:S/SilentService2/SilentService2.slave
Silicon Dreams	S/Silicon Dreams	A-Games:S/SiliconDreams/SiliconDreams.Slave
Silk Worm	S/Silk Worm	A-Games:S/Silkworm/Silkworm.slave
SimAnt HiRes	S/SimAnt HiRes	A-Games:S/SimAntHiRes/SimAntHires.slave
SimAnt DE HiRes	S/SimAnt DE HiRes	A-Games:S/SimAntHiResDe/SimAntHiresDe.slave
SimAnt FR HiRes	S/SimAnt FR HiRes	A-Games:S/SimAntHiResFr/SimAntHiresFr.slave
SimAnt LoRes	S/SimAnt LoRes	A-Games:S/SimAntLoRes/SimAntLoRes.slave
SimAnt DE LoRes	S/SimAnt DE LoRes	A-Games:S/SimAntLoResDe/SimAntLoResDe.slave
SimAnt FR LoRes	S/SimAnt FR LoRes	A-Games:S/SimAntLoResFr/SimAntLoResFr.slave
Sim City	S/Sim City	A-Games:S/SimCity12/SimCity12.Slave
Sim City 512KB	S/Sim City 512KB	A-Games:S/SimCity512KB/SimCity512KB.Slave
Sim City CDTV	S/Sim City CDTV	A-Games:S/SimCityCDTV/SimCityCDTV.Slave
SimEarth HiRes	S/SimEarth HiRes	A-Games:S/SimEarthHiRes/SimEarthHiRes.Slave
SimEarth DE HiRes	S/SimEarth DE HiRes	A-Games:S/SimEarthHiResDe/SimEarthHiResDe.Slave
SimEarth FR HiRes	S/SimEarth FR HiRes	A-Games:S/SimEarthHiResFr/SimEarthHiResFr.Slave
SimEarth LoRes	S/SimEarth LoRes	A-Games:S/SimEarthLoRes/SimEarthLoRes.Slave
SimEarth DE LoRes	S/SimEarth DE LoRes	A-Games:S/SimEarthLoResDe/SimEarthLoResDe.Slave
SimEarth FR LoRes	S/SimEarth FR LoRes	A-Games:S/SimEarthLoResFr/SimEarthLoResFr.Slave
SimLife	S/SimLife	A-Games:S/SimLife/SimLife.Slave
SimLife AGA	S/SimLife AGA	A-Games:S/SimLifeAGA/SimLifeAGA.Slave
SimLife DE	S/SimLife DE	A-Games:S/SimLifeDe/SimLifeDe.Slave
Simon the Sorcerer	S/Simon the Sorcerer	A-Games:S/SimonTheSorcerer/SimonTheSorcerer.Slave
Simon the Sorcerer AGA	S/Simon the Sorcerer AGA	A-Games:S/SimonTheSorcererAGA/SimonTheSorcererAGA.Slave
Simon the Sorcerer DE AGA	S/Simon the Sorcerer DE AGA	A-Games:S/SimonTheSorcererAGADe/SimonTheSorcererAGADe.Slave
Simon the Sorcerer FR AGA	S/Simon the Sorcerer FR AGA	A-Games:S/SimonTheSorcererAGAFr/SimonTheSorcererAGAFr.Slave
Simon the Sorcerer DE	S/Simon the Sorcerer DE	A-Games:S/SimonTheSorcererDe/SimonTheSorcererDe.Slave
Simon the Sorcerer FR	S/Simon the Sorcerer FR	A-Games:S/SimonTheSorcererFr/SimonTheSorcererFr.Slave
Simulcra	S/Simulcra	A-Games:S/Simulcra/Simulcra.Slave
Sinbad and the Throne of the Falcon	S/Sinbad and the Throne of t	A-Games:S/Sinbad/Sinbad.Slave
Sink or Swim 1MB	S/Sink or Swim 1MB	A-Games:S/SinkOrSwim1MB/SinkOrSwim1MB.Slave
Sink or Swim 512KB	S/Sink or Swim 512KB	A-Games:S/SinkOrSwim512KB/SinkOrSwim512KB.Slave
Sir Fred: The Legend	S/Sir Fred The Legend	A-Games:S/SirFredTheLegend/SirFredTheLegend.slave
Sixiang	S/Sixiang	A-Games:S/Sixiang/Sixiang.Slave
Skærmtrolden Hugo DK	S/Skrmtrolden Hugo DK	A-Games:S/SkaermtroldenHugoDk/SkaermtroldenHugoDk.Slave
Skate of the Art	S/Skate of the Art	A-Games:S/SkateOfTheArt/SkateOfTheArt.Slave
Skeet Shoot	S/Skeet Shoot	A-Games:S/SkeetShoot/SkeetShoot.Slave
Skeleton Krew AGA	S/Skeleton Krew AGA	A-Games:S/SkeletonKrewAGA/SkeletonKrewAGA.slave
Skeleton Krew CD32	S/Skeleton Krew CD32	A-Games:S/SkeletonKrewCD32/SkeletonKrewCD32.slave
Skidmarks	S/Skidmarks	A-Games:S/Skidmarks/Skidmarks.slave
Skidmarks AGA	S/Skidmarks AGA	A-Games:S/SkidmarksAGA/SkidmarksAGA.slave
Skidz	S/Skidz	A-Games:S/Skidz/Skidz.Slave
Ski or Die	S/Ski or Die	A-Games:S/SkiOrDie/SkiOrDie.Slave
Skrull	S/Skrull	A-Games:S/Skrull/Skrull.Slave
Skull & Crossbones	S/Skull Crossbones	A-Games:S/Skull&Crossbones/Skull&CrossBones.slave
Skweek	S/Skweek	A-Games:S/Skweek/Skweek.Slave
SkyChase	S/SkyChase	A-Games:S/SkyChase/SkyChase.Slave
SkyChase FAST	S/SkyChase FAST	A-Games:S/SkyChaseFast/SkyChaseFast.Slave
Skyfox	S/Skyfox	A-Games:S/Skyfox/Skyfox.slave
Skyfox II: The Cygnus Conflict	S/Skyfox II The Cygnus Confl	A-Games:S/Skyfox2/Skyfox2.Slave
Sky High Stuntman	S/Sky High Stuntman	A-Games:S/SkyHighStuntman/SkyHighStuntman.Slave
Slackskin & Flint	S/Slackskin Flint	A-Games:S/Slackskin&Flint/Slackskin&Flint.Slave
Slamtilt AGA	S/Slamtilt AGA	A-Games:S/SlamTiltAGA/SlamTiltAGA.Slave
Slamtilt AGA 2MB	S/Slamtilt AGA 2MB	A-Games:S/SlamTiltAGA2MB/SlamTiltAGA2MB.Slave
Slamtilt AGA Demo	S/Slamtilt AGA Demo	A-Games:S/SlamTiltDemoAGA/SlamTiltDemoAGA.Slave
Slayer	S/Slayer	A-Games:S/Slayer/Slayer.Slave
Sleeping Gods Lie	S/Sleeping Gods Lie	A-Games:S/SleepingGodsLie/SleepingGodsLie.Slave
Sleepwalker	S/Sleepwalker	A-Games:S/Sleepwalker/Sleepwalker.Slave
Sleepwalker AGA	S/Sleepwalker AGA	A-Games:S/SleepwalkerAGA/SleepwalkerAGA.Slave
Sleepwalker AGA ComicRelief	S/Sleepwalker AGA ComicRelie	A-Games:S/SleepwalkerAGAComicRelief/SleepwalkerAGAComicRelief.Slave
Sleepwalker ComicRelief	S/Sleepwalker ComicRelief	A-Games:S/SleepwalkerComicRelief/SleepwalkerComicRelief.Slave
Sliders	S/Sliders	A-Games:S/Sliders/Sliders.Slave
Slightly Magic	S/Slightly Magic	A-Games:S/SlightlyMagic/SlightlyMagic.slave
Slip Stream	S/Slip Stream	A-Games:S/SlipStream/SlipStream.Slave
Sly Spy: Secret Agent	S/Sly Spy Secret Agent	A-Games:S/SlySpySecretAgent/SlySpySecretAgent.slave
Smash TV	S/Smash TV	A-Games:S/SmashTV/SmashTV.Slave
Snapperazzi	S/Snapperazzi	A-Games:S/Snapperazzi/Snapperazzi.Slave
Sneech	S/Sneech	A-Games:S/Sneech/Sneech.Slave
Snoopy and Peanuts	S/Snoopy and Peanuts	A-Games:S/Snoopy&Peanuts/Snoopy&Peanuts.Slave
Snoopy and Peanuts NoSounds	S/Snoopy and Peanuts NoSound	A-Games:S/Snoopy&PeanutsNoSounds/Snoopy&PeanutsNoSounds.Slave
Snow Bros. Files	S/Snow Bros. Files	A-Games:S/SnowBrosFiles/SnowBrosFiles.Slave
Snow Bros. Image	S/Snow Bros. Image	A-Games:S/SnowBrosImage/SnowBrosImage.Slave
Snow Strike	S/Snow Strike	A-Games:S/SnowStrike/SnowStrike.Slave
Soccer Kid	S/Soccer Kid	A-Games:S/SoccerKid/SoccerKid.Slave
Soccer Kid AGA	S/Soccer Kid AGA	A-Games:S/SoccerKidAGA/SoccerKidAGA.Slave
Soccer Kid CD32	S/Soccer Kid CD32	A-Games:S/SoccerKidCD32/SoccerKidCD32.Slave
Soccer Pinball	S/Soccer Pinball	A-Games:S/SoccerPinball/SoccerPinball.slave
Soccer Superstars	S/Soccer Superstars	A-Games:S/SoccerSuperstars/SoccerSuperstars.Slave
Soccer Superstars AGA	S/Soccer Superstars AGA	A-Games:S/SoccerSuperstarsAGA/SoccerSuperstarsAGA.Slave
Soccer Superstars DE	S/Soccer Superstars DE	A-Games:S/SoccerSuperstarsDe/SoccerSuperstarsDe.Slave
Soldier 2000	S/Soldier 2000	A-Games:S/Soldier2000/Soldier2000.Slave
Soldier of Light	S/Soldier of Light	A-Games:S/SoldierOfLight/SoldierOfLight.slave
Solid Gold	S/Solid Gold	A-Games:S/SolidGold/SolidGold.slave
Solomon's Key 2	S/Solomons Key 2	A-Games:S/SolomonsKey2/SolomonsKey2.Slave
Sonic Boom	S/Sonic Boom	A-Games:S/SonicBoom/SonicBoom.slave
Son Shu-Shi	S/Son Shu-Shi	A-Games:S/SonShuShi/SonShuShi.Slave
Sooty & Sweep	S/Sooty Sweep	A-Games:S/Sooty&Sweep/Sooty&Sweep.Slave
Sooty's Fun With Numbers	S/Sootys Fun With Numbers	A-Games:S/SootysFunWithNumbers/SootysFunWithNumbers.slave
Sophelie	S/Sophelie	A-Games:S/Sophelie/Sophelie.Slave
Sorcerer Lord	S/Sorcerer Lord	A-Games:S/SorcererLord/SorcererLord.Slave
Sorcerer Lord FR	S/Sorcerer Lord FR	A-Games:S/SorcererLordFr/SorcererLordFr.Slave
Sorceror's Apprentice	S/Sorcerors Apprentice	A-Games:S/SorcerorsApprentice/SorcerorsApprentice.Slave
Sorcery Plus	S/Sorcery Plus	A-Games:S/SorceryPlus/SorceryPlus.Slave
Sorefist	S/Sorefist	A-Games:S/Sorefist/Sorefist.Slave
Space Ace	S/Space Ace	A-Games:S/SpaceAce/SpaceAce.slave
Space Ace II: Borf's Revenge	S/Space Ace II Borfs Revenge	A-Games:S/SpaceAce2/SpaceAce2.Slave
Space Ace Demo	S/Space Ace Demo	A-Games:S/SpaceAceDemo/SpaceAceDemo.Slave
Space Assault	S/Space Assault	A-Games:S/SpaceAssault/SpaceAssault.slave
Spaceball	S/Spaceball	A-Games:S/Spaceball/Spaceball.Slave
Space Crusade	S/Space Crusade	A-Games:S/SpaceCrusade/SpaceCrusade.Slave
Space Crusade VoyageBeyond	S/Space Crusade VoyageBeyond	A-Games:S/SpaceCrusade&VoyageBeyond/VoyageBeyond.Slave
Space Crusade VoyageBeyond	S/Space Crusade VoyageBey V2	A-Games:S/SpaceCrusade&VoyageBeyond/SpaceCrusade.Slave
Spacecutter	S/Spacecutter	A-Games:S/Spacecutter/Spacecutter.Slave
Space Gun	S/Space Gun	A-Games:S/SpaceGun/SpaceGun.Slave
Space Harrier	S/Space Harrier	A-Games:S/SpaceHarrier/SpaceHarrier.Slave
Space Harrier RetrnFntZone	S/Space Harrier RetrnFntZone	A-Games:S/SpaceHarrier&RetrnFntZone/SpaceHarrier.slave
Space Harrier II	S/Space Harrier II	A-Games:S/SpaceHarrier2/SpaceHarrier2.Slave
Space Harrier NTSC	S/Space Harrier NTSC	A-Games:S/SpaceHarrierNTSC/SpaceHarrierNTSC.Slave
Space Hulk	S/Space Hulk	A-Games:S/SpaceHulk/SpaceHulk.Slave
Space MAX DE	S/Space MAX DE	A-Games:S/SpaceMAXDe/SpaceMAXDe.Slave
Space Pilot 89	S/Space Pilot 89	A-Games:S/SpacePilot89/SpacePilot89.Slave
Space Quest	S/Space Quest	A-Games:S/SpaceQuest/SpaceQuest.Slave
Space Quest II	S/Space Quest II	A-Games:S/SpaceQuest2/SpaceQuest2.slave
Space Quest III: The Pirates of Pestulon	S/Space Quest III The Pirate	A-Games:S/SpaceQuest3/SpaceQuest3.slave
Space Quest III: The Pirates of Pestulon DE	S/Space Quest III The Pir V2	A-Games:S/SpaceQuest3De/SpaceQuest3De.slave
Space Quest IV	S/Space Quest IV	A-Games:S/SpaceQuest4/SpaceQuest4.slave
Space Quest IV DE	S/Space Quest IV DE	A-Games:S/SpaceQuest4De/SpaceQuest4De.slave
Space Quest: The Sarien Encounter	S/Space Quest The Sarien Enc	A-Games:S/SpaceQuestEnhanced/SpaceQuestEnhanced.slave
Space Racer	S/Space Racer	A-Games:S/SpaceRacer/SpaceRacer.Slave
Space Racer FR	S/Space Racer FR	A-Games:S/SpaceRacerFr/SpaceRacerFr.Slave
Space Ranger	S/Space Ranger	A-Games:S/SpaceRangerArcadia/SpaceRangerArcadia.Slave
Space Rogue	S/Space Rogue	A-Games:S/SpaceRogue/SpaceRogue.Slave
Space Station Oblivion	S/Space Station Oblivion	A-Games:S/SpaceStation/SpaceStation.Slave
Special Forces	S/Special Forces	A-Games:S/SpecialForces/SpecialForces.slave
Speedball	S/Speedball	A-Games:S/Speedball/Speedball.slave
Speedball 2: Brutal Deluxe	S/Speedball 2 Brutal Deluxe	A-Games:S/Speedball2/Speedball2.Slave
Speedball 2: Brutal Deluxe CD32	S/Speedball 2 Brutal Deluxe 	A-Games:S/Speedball2CD32/Speedball2CD32.Slave
Speedball 2: Brutal Deluxe NTSC	S/Speedball 2 Brutal Delu V2	A-Games:S/Speedball2NTSC/Speedball2NTSC.Slave
Speedball NTSC	S/Speedball NTSC	A-Games:S/SpeedballNTSC/SpeedballNTSC.slave
Speedboat Assassin	S/Speedboat Assassin	A-Games:S/SpeedboatAssassins/SpeedboatAssassins.Slave
Speed Buggy	S/Speed Buggy	A-Games:S/SpeedBuggy/SpeedBuggy.slave
Spell Bound	S/Spell Bound	A-Games:S/SpellBound/SpellBound.Slave
Spellbound Dizzy	S/Spellbound Dizzy	A-Games:S/SpellboundDizzy/SpellboundDizzy.Slave
Sorcerer	S/Sorcerer	A-Games:S/SpellfireTheSorcerer/SpellfireTheSorcerer.slave
Speris Legacy, The AGA	S/Speris Legacy. The AGA	A-Games:S/SperisLegacyAGA/SperisLegacyAGA.Slave
Speris Legacy, The CD32	S/Speris Legacy. The CD32	A-Games:S/SperisLegacyCD32/SperisLegacyCD32.Slave
Spherical	S/Spherical	A-Games:S/Spherical/Spherical.Slave
Spherical Worlds	S/Spherical Worlds	A-Games:S/SphericalWorlds/SphericalWorlds.Slave
Spherical Worlds CD	S/Spherical Worlds CD	A-Games:S/SphericalWorldsCD/SphericalWorldsCD.Slave
Spike In Transylvania	S/Spike In Transylvania	A-Games:S/SpikeInTransylvania/SpikeInTransylvania.Slave
Spindizzy Worlds	S/Spindizzy Worlds	A-Games:S/SpindizzyWorlds/SpindizzyWorlds.slave
Spirit of Adventure DE 1Disk	S/Spirit of Adventure DE 1Di	A-Games:S/SpiritOfAdventureDe1Disk/SpiritOfAdventureDe1Disk.slave
Spirit of Adventure DE 3Disk	S/Spirit of Adventure DE 3Di	A-Games:S/SpiritOfAdventureDe3Disk/SpiritOfAdventureDe3Disk.slave
Spitting Image Image	S/Spitting Image Image	A-Games:S/SpittingImage/SpittingImage.slave
Spot	S/Spot	A-Games:S/Spot/Spot.Slave
Spot	S/Spot 	A-Games:S/SpotArcadia/SpotArcadia.Slave
Spy vs Spy	S/Spy vs Spy	A-Games:S/SpyVsSpy/SpyVsSpy.Slave
Spy vs Spy II: The Island Caper	S/Spy vs Spy II The Island C	A-Games:S/SpyVsSpy2TheIslandCaper/SpyVsSpy2TheIslandCaper.Slave
Spy vs Spy III - Arctic Antics	S/Spy vs Spy III - Arctic An	A-Games:S/SpyVsSpy3ArcticAntics/SpyVsSpy3ArcticAntics.Slave
Spy Who Loved Me, The	S/Spy Who Loved Me. The	A-Games:S/SpyWhoLovedMe/SpyWhoLovedMe.Slave
Sqrxz	S/Sqrxz	A-Games:S/Sqrxz/Sqrxz.Slave
Stack Up	S/Stack Up	A-Games:S/StackUp/StackUp.Slave
Starbirds	S/Starbirds	A-Games:S/Starbirds/Starbirds.Slave
Starblade	S/Starblade	A-Games:S/Starblade/Starblade.Slave
Starblade FAST	S/Starblade FAST	A-Games:S/StarbladeFast/StarbladeFast.slave
Starblade FR FAST	S/Starblade FR FAST	A-Games:S/StarbladeFastFr/StarbladeFastFr.slave
Starblade FR	S/Starblade FR	A-Games:S/StarbladeFr/StarbladeFr.Slave
Starblaze	S/Starblaze	A-Games:S/Starblaze/Starblaze.slave
Star Command	S/Star Command	A-Games:S/StarCommand/StarCommand.Slave
Star Control	S/Star Control	A-Games:S/StarControl/StarControl.Slave
Star Crusader AGA	S/Star Crusader AGA	A-Games:S/StarCrusaderAGA/StarCrusaderAGA.Slave
Stardust	S/Stardust	A-Games:S/Stardust/Stardust.slave
Starglider	S/Starglider	A-Games:S/Starglider/Starglider.Slave
Starglider 2	S/Starglider 2	A-Games:S/Starglider2/Starglider2.Slave
Star Goose!	S/Star Goose	A-Games:S/StarGoose/StarGoose.Slave
Starians	S/Starians	A-Games:S/Starians/Starians.slave
Starlord	S/Starlord	A-Games:S/Starlord/Starlord.Slave
Starlord DE	S/Starlord DE	A-Games:S/StarlordDe/StarlordDe.Slave
Starlord FR	S/Starlord FR	A-Games:S/StarlordFr/StarlordFr.Slave
StarRay 1Disk	S/StarRay 1Disk	A-Games:S/StarRay1Disk/StarRay1Disk.slave
StarRay 2Disk	S/StarRay 2Disk	A-Games:S/StarRay2Disk/StarRay2Disk.slave
StarTrash	S/StarTrash	A-Games:S/StarTrash/StarTrash.slave
Star Trek: 25th Anniversary AGA	S/Star Trek 25th Anniversary	A-Games:S/StarTrek25thAnnivAGA/StarTrek25thAnnivAGA.Slave
Star Trek: 25th Anniversary DE AGA	S/Star Trek 25th Annivers V2	A-Games:S/StarTrek25thAnnivAGADe/StarTrek25thAnnivAGADe.Slave
Star Trek: 25th Anniversary FR AGA	S/Star Trek 25th Annivers V3	A-Games:S/StarTrek25thAnnivAGAFr/StarTrek25thAnnivAGAFr.Slave
Starush Files	S/Starush Files	A-Games:S/StarushFiles/StarushFiles.Slave
Starush Image	S/Starush Image	A-Games:S/StarushImage/StarushImage.Slave
Star Wars	S/Star Wars	A-Games:S/StarWars/StarWars.Slave
Steel	S/Steel	A-Games:S/Steel/Steel.Slave
Steel Empire	S/Steel Empire	A-Games:S/SteelEmpire/SteelEmpire.Slave
Steg the Slug	S/Steg the Slug	A-Games:S/StegTheSlug/StegTheSlug.slave
Steigar	S/Steigar	A-Games:S/Steigar/Steigar.Slave
Stellar 7	S/Stellar 7	A-Games:S/Stellar7/Stellar7.Slave
Stellar 7 DE	S/Stellar 7 DE	A-Games:S/Stellar7De/Stellar7De.Slave
Stone Age	S/Stone Age	A-Games:S/StoneAge/StoneAge.slave
Stormball	S/Stormball	A-Games:S/Stormball/Stormball.Slave
Stormlord	S/Stormlord	A-Games:S/Stormlord/Stormlord.Slave
Stormlord NTSC	S/Stormlord NTSC	A-Games:S/StormlordNTSC/StormlordNTSC.Slave
Stormlord Prerelease	S/Stormlord Prerelease	A-Games:S/StormlordPrerelease/StormlordPrerelease.Slave
Storm Master	S/Storm Master	A-Games:S/StormMaster/StormMaster.Slave
Storm Master DE	S/Storm Master DE	A-Games:S/StormMasterDe/StormMasterDe.Slave
Storm Master FAST	S/Storm Master FAST	A-Games:S/StormMasterFast/StormMasterFast.Slave
Storm Master DE FAST	S/Storm Master DE FAST	A-Games:S/StormMasterFastDe/StormMasterFastDe.slave
Storm Master FR FAST	S/Storm Master FR FAST	A-Games:S/StormMasterFastFr/StormMasterFastFr.Slave
Storm Master FR	S/Storm Master FR	A-Games:S/StormMasterFr/StormMasterFr.Slave
Stratego	S/Stratego	A-Games:S/Stratego/Stratego.Slave
Street Fighter	S/Street Fighter	A-Games:S/StreetFighter/StreetFighter.slave
Street Fighter II: The World Warrior	S/Street Fighter II The Worl	A-Games:S/StreetFighter2/StreetFighter2.Slave
Street Gang	S/Street Gang	A-Games:S/StreetGang/StreetGang.slave
Street Racer CD32	S/Street Racer CD32	A-Games:S/StreetRacerCD32/StreetRacerCD32.slave
Street Rod	S/Street Rod	A-Games:S/StreetRod/StreetRod.slave
Street Rod 2	S/Street Rod 2	A-Games:S/StreetRod2/StreetRod2.Slave
Street Sports Basketball	S/Street Sports Basketball	A-Games:S/StreetSportsBasketball/StreetSportsBasketball.Slave
Strider	S/Strider	A-Games:S/Strider/Strider.Slave
Strider II	S/Strider II	A-Games:S/Strider2/Strider2.Slave
Strike Aces	S/Strike Aces	A-Games:S/StrikeAces/StrikeAces.Slave
Striker	S/Striker	A-Games:S/Striker/Striker.slave
Strip Poker: A Sizzling Game of Chance	S/Strip Poker A Sizzling Gam	A-Games:S/StripPoker/StripPoker.slave
Strip Poker II	S/Strip Poker II	A-Games:S/StripPoker2/StripPoker2.slave
Strip Poker II	S/Strip Poker II 	A-Games:S/StripPoker2+/StripPoker2+.Slave
Strip Poker II DataDisk1	S/Strip Poker II DataDisk1	A-Games:S/StripPoker2+&DataDisk1/StripPoker2+&DataDisk1.Slave
Strip Pot AGA	S/Strip Pot AGA	A-Games:S/StripPotAGA/StripPotAGA.Slave
Strip Pot CD32	S/Strip Pot CD32	A-Games:S/StripPotCD32/StripPotCD32.Slave
Stryx	S/Stryx	A-Games:S/Stryx/Stryx.Slave
S.T.U.N. Runner	S/S.T.U.N. Runner	A-Games:S/STUNRunner/STUNRunner.Slave
Stunt Car Racer	S/Stunt Car Racer	A-Games:S/StuntCarRacer/StuntCarRacer.Slave
Stunt Car Racer	S/Stunt Car Racer 	A-Games:S/StuntCarRacerTNT/StuntCarRacerTNT.Slave
Stunt Track Racer	S/Stunt Track Racer	A-Games:S/StuntTrackRacer/StuntTrackRacer.Slave
Sub Battle Simulator	S/Sub Battle Simulator	A-Games:S/SubBattleSimulator/SubBattleSimulator.Slave
Subbuteo: The Computer Game	S/Subbuteo The Computer Game	A-Games:S/Subbuteo/Subbuteo.Slave
Subtrade: Return to Irata	S/Subtrade Return to Irata	A-Games:S/Subtrade/Subtrade.slave
Suburban Commando	S/Suburban Commando	A-Games:S/SuburbanCommando/SuburbanCommando.Slave
Subwar 2050 AGA	S/Subwar 2050 AGA	A-Games:S/Subwar2050AGA/Subwar2050AGA.slave
Subwar 2050 CD32	S/Subwar 2050 CD32	A-Games:S/Subwar2050CD32/Subwar2050CD32.slave
Summer Camp	S/Summer Camp	A-Games:S/SummerCamp/SummerCamp.Slave
Summer Challenge	S/Summer Challenge	A-Games:S/SummerChallenge/SummerChallenge.Slave
Summer Games	S/Summer Games	A-Games:S/SummerGames/SummerGames.slave
Summer Games SummerGames2	S/Summer Games SummerGames2	A-Games:S/SummerGames&SummerGames2/SummerGames&SummerGames2.slave
Summer Games II	S/Summer Games II	A-Games:S/SummerGames2/SummerGames2.slave
Summer Olympiad	S/Summer Olympiad	A-Games:S/SummerOlympiad/SummerOlympiad.Slave
Supaplex	S/Supaplex	A-Games:S/Supaplex/Supaplex.Slave
Super C	S/Super C	A-Games:S/SuperC/SuperC.Slave
Super Cars 1Disk	S/Super Cars 1Disk	A-Games:S/SuperCars1Disk/SuperCars1Disk.Slave
Super Cars II	S/Super Cars II	A-Games:S/SuperCars2/SuperCars2.Slave
Super Cars 2Disk	S/Super Cars 2Disk	A-Games:S/SuperCars2Disk/SuperCars2Disk.Slave
Super Cauldron	S/Super Cauldron	A-Games:S/SuperCauldron/SuperCauldron.Slave
Super C FAST	S/Super C FAST	A-Games:S/SuperCFast/SuperCFast.Slave
Superfrog Intro	S/Superfrog Intro	A-Games:S/Superfrog/SuperfrogIntro.Slave
Superfrog	S/Superfrog	A-Games:S/Superfrog/Superfrog.Slave
Superfrog CD32	S/Superfrog CD32	A-Games:S/SuperfrogCD32/SuperfrogCD32.Slave
Superfrog Intro CD32	S/Superfrog Intro CD32	A-Games:S/SuperfrogCD32/SuperfrogIntroCD32.Slave
Superfrog Demo AmigaAction	S/Superfrog Demo AmigaAction	A-Games:S/SuperfrogDemoAmigaAction/SuperfrogDemoAmigaAction.Slave
Superfrog Demo CUAmiga	S/Superfrog Demo CUAmiga	A-Games:S/SuperfrogDemoCUAmiga/SuperfrogDemoCUAmiga.Slave
Superfrog Demo TheOne	S/Superfrog Demo TheOne	A-Games:S/SuperfrogDemoTheOne/SuperfrogDemoTheOne.Slave
Super Grand Prix	S/Super Grand Prix	A-Games:S/SuperGrandPrix/SuperGrandPrix.Slave
Super Hang-On	S/Super Hang-On	A-Games:S/SuperHangOn/SuperHangOn.Slave
Superhero Demo	S/Superhero Demo	A-Games:S/SuperheroDemo/SuperheroDemo.Slave
Super Loopz AGA	S/Super Loopz AGA	A-Games:S/SuperLoopzAGA/SuperLoopzAGA.Slave
Superman: The Man of Steel	S/Superman The Man of Steel	A-Games:S/Superman/Superman.Slave
Super Methane Bros	S/Super Methane Bros	A-Games:S/SuperMethaneBros/SuperMethaneBros.Slave
Super Methane Bros CD32	S/Super Methane Bros CD32	A-Games:S/SuperMethaneBrosCD32/SuperMethaneBrosCD32.Slave
Super Monaco GP	S/Super Monaco GP	A-Games:S/SuperMonacoGP/SuperMonacoGP.slave
Super Monaco GP	S/Super Monaco GP 	A-Games:S/SuperMonacoGP/SuperMonacoGP.Slave
Super Obliteration	S/Super Obliteration	A-Games:S/SuperObliteration/SuperObliteration.Slave
Super OsWALD DK	S/Super OsWALD DK	A-Games:S/SuperOsWALDDk/SuperOsWALDDk.Slave
Super Scramble Simulator	S/Super Scramble Simulator	A-Games:S/SuperScrambleSimulator/SuperScrambleSimulator.slave
Super Seymour	S/Super Seymour	A-Games:S/SuperSeymourSavesPlanet/SuperSeymourSavesPlanet.slave
Super Ski	S/Super Ski	A-Games:S/SuperSki/SuperSki.Slave
Super Ski II	S/Super Ski II	A-Games:S/SuperSki2/SuperSki2.slave
Super Skidmarks CD32	S/Super Skidmarks CD32	A-Games:S/SuperSkidmarksCD32/SuperSkidmarksCD32.slave
Super Skidmarks CD32 LOWMEM	S/Super Skidmarks CD32 LOWME	A-Games:S/SuperSkidmarksLowMemCD32/SuperSkidMarksLowMemCD32.slave
Super Ski FR	S/Super Ski FR	A-Games:S/SuperSkiFr/SuperSkiFr.Slave
Super Skweek 1MB	S/Super Skweek 1MB	A-Games:S/SuperSkweek1MB/SuperSkweek1MB.Slave
Super Skweek 512KB	S/Super Skweek 512KB	A-Games:S/SuperSkweek512KB/SuperSkweek512KB.Slave
Super Space Invaders	S/Super Space Invaders	A-Games:S/SuperSpaceInvaders/SuperSpaceInvaders.slave
Super Stardust AGA	S/Super Stardust AGA	A-Games:S/SuperStardustAGA/SuperStardustAGA.Slave
Superstar Ice Hockey	S/Superstar Ice Hockey	A-Games:S/SuperstarIceHockey/SuperstarIceHockey.Slave
Super Street Fighter II: The New Challengers	S/Super Street Fighter II Th	A-Games:S/SuperStreetFighter2/SuperStreetFighter2.Slave
Super Street Fighter II: The New Challengers AGA	S/Super Street Fighter II V2	A-Games:S/SuperStreetFighter2AGA/SuperStreetFighter2AGA.Slave
Super Street Fighter II: The New Challengers AGA	S/Super Street Fighter II V3	A-Games:S/SuperStreetFighter2DXAGA/SuperStreetFighter2DXAGA.Slave
Super Tetris	S/Super Tetris	A-Games:S/SuperTetris/SuperTetris.Slave
Super Twintris	S/Super Twintris	A-Games:S/SuperTwintris/SuperTwintris.Slave
Supremacy	S/Supremacy	A-Games:S/Supremacy/Supremacy.Slave
Super Street Fighter II Turbo Intro AGA	S/Super Street Fighter II Tu	A-Games:S/SuprStrtFtr2TrboAGA/SuprStrtFtr2TrboIntroAGA.slave
Super Street Fighter II Turbo AGA	S/Super Street Fighter II V4	A-Games:S/SuprStrtFtr2TrboAGA/SuprStrtFtr2TrboAGA.slave
Super Street Fighter II Turbo CD32	S/Super Street Fighter II V5	A-Games:S/SuprStrtFtr2TrboCD32/SuprStrtFtr2TrboCD32.slave
Super Street Fighter II Turbo Intro CD32	S/Super Street Fighter II V6	A-Games:S/SuprStrtFtr2TrboCD32/SuprStrtFtr2TrboIntroCD32.slave
Super Tennis Champs	S/Super Tennis Champs	A-Games:S/SuprTennisChmps/SuprTennisChmps.Slave
Super Tennis Champs DataDisk	S/Super Tennis Champs DataDi	A-Games:S/SuprTennisChmps&DataDisks/SuprTennisChmps&DataDisks.Slave
Surf Ninjas AGA	S/Surf Ninjas AGA	A-Games:S/SurfNinjasAGA/SurfNinjasAGA.slave
Suspicious Cargo	S/Suspicious Cargo	A-Games:S/SuspiciousCargo/SuspiciousCargo.Slave
Swap	S/Swap	A-Games:S/Swap/Swap.Slave
Swap FR	S/Swap FR	A-Games:S/SwapFr/SwapFr.Slave
Switchblade	S/Switchblade	A-Games:S/Switchblade/Switchblade.Slave
Switchblade II	S/Switchblade II	A-Games:S/Switchblade2/Switchblade2.Slave
SWIV	S/SWIV	A-Games:S/SWIV/SWIV.Slave
Swooper	S/Swooper	A-Games:S/Swooper/Swooper.Slave
Sword	S/Sword	A-Games:S/Sword/Sword.Slave
Sword & The Rose, The	S/Sword The Rose. The	A-Games:S/Sword&TheRose/Sword&TheRose.slave
Sword of Honour	S/Sword of Honour	A-Games:S/SwordOfHonour/SwordOfHonour.slave
Sword of Sodan	S/Sword of Sodan	A-Games:S/SwordOfSodan/SwordOfSodan.slave
Swords & Galleons	S/Swords Galleons	A-Games:S/Swords&Galleons/Swords&Galleons.slave
Swords of Twilight	S/Swords of Twilight	A-Games:S/SwordsOfTwilight/SwordsOfTwilight.Slave
Syndicate	S/Syndicate	A-Games:S/Syndicate/Syndicate.slave
Syndicate CD32	S/Syndicate CD32	A-Games:S/SyndicateCD32/SyndicateCD32.slave
Syndicate DE	S/Syndicate DE	A-Games:S/SyndicateDe/SyndicateDe.slave
SportTime Table Hockey	S/SportTime Table Hockey	A-Games:T/TableHockeyArcadia/TableHockeyArcadia.Slave
SportTime Ten Pin Bowling	S/SportTime Ten Pin Bowling	A-Games:T/TenPinBowlingArcadia/TenPinBowlingArcadia.Slave